abadi	a b a d i
abang	a b a ŋ
abay	a b a j
abbas	a b b a s
abda	a b d a
abdel	a b d ə l
abdul	a b d u l
abdullah	a b d u l a h
abdurrahman	a b d u r a h m a n
abdurrhaman	a b d u r r h a m a n
abdus	a b d u s
abepura	a b ə p u r a
aberson	a b ɛ r s o n
abg	a b ɡ
abidin	a b i d i n
abimanyu	a b i m a ɲ u
abri	a b r i
abstain	a b s t aɪ n
absurd	a b s u r d
abu	a b u
ac	a tʃ
acara	a tʃ a r a
aceh	a tʃ ə h
achmad	a χ m a d
achwan	a χ w a n
achyar	a χ j a r
acung	a tʃ u ŋ
ad	a d
ad-hoc	a d h o tʃ
ada	a d a
adakan	a d a k a n
adalah	a d a l a h
adam	a d a m
adams	a d a m s
adang	a d a ŋ
adanya	a d a ɲ a
adapun	a d a p u n
adat	a d a t
ade	a d ə
adi	a d i
adik	a d i k
adil	a d i l
adis	a d i s
administrasi	a d m i n i s t r a s i
administrator	a d m i n i s t r a t ɔ r
admojo	a d m o dʒ o
adnan	a d n a n
adnyana	a d ɲ a n a
adu	a d u
advokad	a d v o k a d
afan	a f a n
afgan	a f ɡ a n
afganistan	a f ɡ a n i s t a n
afsel	a f s ə l
agak	a ɡ a k
agama	a ɡ a m a
agar	a ɡ a r
agfar	a ɡ f a r
agnes	a ɡ n ə s
agung	a ɡ u ŋ
agus	a ɡ u s
agustus	a ɡ u s t u s
agwunobi	a ɡ w u n o b i
ah	a h
ahli	a h l i
ahmad	a h m a d
ahmed	a h m ə d
air	aɪ r
airlangga	aɪ r l a ŋ ɡ a
airnya	aɪ r ɲ a
aisyiyah	aɪ ç i j a h
aja	a dʒ a
ajak	a dʒ a k
ajang	a dʒ a ŋ
aji	a dʒ i
ajinomoto	a dʒ i n o m o t o
ajukan	a dʒ u k a n
ajun	a dʒ u n
akad	a k a d
akademisi	a k a d ə m i s i
akan	a k a n
akbar	a k b a r
akhir	a x i r
akhir-akhir	a x i r a x i r
akhirat	a x i r a t
akhirnya	a x i r ɲ a
akhlak	a x l a k
akhmad	a x m a d
akhmadi	a x m a d i
akibat	a k i b a t
akibatnya	a k i b a t ɲ a
akrab	a k r a b
akrabnya	a k r a b ɲ a
aksi	a k s i
aktif	a k t i f
aktiva	a k t i v a
aktivis	a k t i v i s
aktor-aktor	a k t ɔ r a k t ɔ r
aku	a k u
akui	a k u i
akun	a k u n
ala	a l a
alam	a l a m
alamat	a l a m a t
alami	a l a m i
alamsyah	a l a m ç a h
alangkah	a l a ŋ k a h
alasan	a l a s a n
alat	a l a t
albar	a l b a r
albert	a l b ə r t
album	a l b u m
aldouri	a l d o u r i
alergen	a l ɛ r ɡ ə n
alex	a l ə k s
alfa	a l f a
alfred	a l f r ə d
ali	a l i
alien	a l i n
aliran	a l i r a n
alkhairaat	a l x aɪ r a a t
alkotsar	a l k o t s a r
almarhum	a l m a r h u m
alpa	a l p a
alternatif	a l t ə r n a t i f
aluminium	a l u m i n i u m
alvi	a l v i
alwi	a l w i
amahorseya	a m a h ɔ r s ɛ j a
amal	a m a l
amandemen	a m a n d ɛ m ə n
amang	a m a ŋ
amar	a m a r
amaral	a m a r a l
amat	a m a t
amati	a m a t i
amazon	a m a z o n
ambas	a m b a s
ambil	a m b i l
ambisinya	a m b i s i ɲ a
ambivalen	a m b i v a l ə n
amblesnya	a m b l ɛ s ɲ a
amboina	a m b o i n a
ambon	a m b o n
ambong	a m b o ŋ
amerika	a m ə r i k a
amien	a m i n
amin	a m i n
amiruddin	a m i r u d d i n
ampas	a m p a s
amplop	a m p l o p
amrozi	a m r o z i
anak	a n a k
anak-anak	a n a k a n a k
anaknya	a n a k ɲ a
anam	a n a m
ancam	a n tʃ a m
ancaman	a n tʃ a m a n
ancol	a n tʃ o l
anda	a n d a
andai	a n d aɪ
andaikan	a n d aɪ k a n
andaipun	a n d aɪ p u n
andalas	a n d a l a s
anderson	a n d ɛ r s o n
andrea	a n d r ɛ a
aneh	a n ə h
anggap	a ŋ ɡ a p
anggaran	a ŋ ɡ a r a n
anggito	a ŋ ɡ i t o
anggoro	a ŋ ɡ ɔ r o
anggota	a ŋ ɡ o t a
angin	a ŋ i n
angkasa	a ŋ k a s a
angkatan	a ŋ k a t a n
angkut	a ŋ k u t
anita	a n i t a
anjlok	a n dʒ l o k
ansyori	a n ç ɔ r i
antar	a n t a r
antara	a n t a r a
antaranya	a n t a r a ɲ a
anthrax	a n t h r a k s
antisipatif	a n t i s i p a t i f
anton	a n t o n
antrean	a n t r ɛ a n
anwar	a n w a r
apa	a p a
apa-apa	a p a a p a
apabila	a p a b i l a
apakah	a p a k a h
apalagi	a p a l a ɡ i
aparat	a p a r a t
aparatnya	a p a r a t ɲ a
apbd	a p b d
apbn	a p b n
apec	a p ə tʃ
api	a p i
aquino	a k w i n o
arab	a r a b
arafat-powell	a r a f a t p o w ə l
arah	a r a h
aransemennya	a r a n s ə m ɛ n ɲ a
ardika	a r d i k a
area	a r ɛ a
areal	a r ɛ a l
arena	a r ɛ n a
argo	a r ɡ o
aribowo	a r i b o w o
arief	a r i f
aries	a r i s
arif	a r i f
arifin	a r i f i n
arioseno	a r i o s ɛ n o
arkeologi	a r k ə o l o ɡ i
armen	a r m ə n
arsitek	a r s i t ə k
arswendo	a r s w ɛ n d o
artefak	a r t ɛ f a k
artidjo	a r t i dʒ o
artikel	a r t i k ə l
artinya	a r t i ɲ a
arun	a r u n
arus	a r u s
aryo	a r j o
as	a s
asal	a s a l
asap	a s a p
asas	a s a s
asasi	a s a s i
asean	a s ɛ a n
asep	a s ə p
aset	a s ə t
ashar	a s h a r
asia	a s i a
asing	a s i ŋ
asli	a s l i
asma	a s m a
asosiasi	a s o s i a s i
aspal	a s p a l
asramagate	a s r a m a ɡ a t ə
asri	a s r i
assegaf	a s ɛ ɡ a f
astra	a s t r a
asumsi	a s u m s i
asuransi	a s u r a n s i
aswj	a s w dʒ
asyari	a ç a r i
asyik	a ç i k
asyiknya	a ç i k ɲ a
atas	a t a s
atasannya	a t a s a n ɲ a
atasnya	a t a s ɲ a
atau	a t aʊ
ataupun	a t aʊ p u n
atidah	a t i d a h
atmosfer	a t m o s f ə r
atmowiloto	a t m o w i l o t o
atribut	a t r i b u t
atrium	a t r i u m
aturan	a t u r a n
auditor	aʊ d i t ɔ r
auditorium	aʊ d i t ɔ r i u m
australia	aʊ s t r a l i a
auzubillah	aʊ z u b i l a h
avi	a v i
awak	a w a k
awal	a w a l
awaloedin	a w a l u d i n
awam	a w a m
ayah	a j a h
ayahnya	a j a h ɲ a
ayam	a j a m
ayamnya	a j a m ɲ a
ayin	a j i n
ayip	a j i p
ayo	a j o
azerbaijan	a z ə r b aɪ dʒ a n
azis	a z i s
aziz	a z i z
azizy	a z i z j
azmi	a z m i
aznan	a z n a n
aznani	a z n a n i
azra	a z r a
azrul	a z r u l
aztarmizi	a z t a r m i z i
azwar	a z w a r
azwir	a z w i r
azyumardi	a z j u m a r d i
azzahra	a z z a h r a
azzam	a z z a m
azzurri	a z z u r i
baasyir	b a a ç i r
babak	b a b a k
bachrumsyah	b a χ r u m ç a h
bachtiar	b a χ t i a r
bactiar	b a tʃ t i a r
badai	b a d aɪ
badak	b a d a k
badan	b a d a n
badannya	b a d a n ɲ a
badar	b a d a r
baehaqi	b a ə h a k i
bagai	b a ɡ aɪ
bagaimana	b a ɡ aɪ m a n a
bagi	b a ɡ i
bagian	b a ɡ i a n
bagimu	b a ɡ i m u
bagja	b a ɡ dʒ a
bagus	b a ɡ u s
bah	b a h
bahan	b a h a n
bahasa	b a h a s a
bahkan	b a h k a n
bahu-membahu	b a h u m ə m b a h u
bahwa	b a h w a
baik	b aɪ k
baiknya	b aɪ k ɲ a
bajaj	b a dʒ a dʒ
baju	b a dʒ u
bakal	b a k a l
bakso	b a k s o
bakteri	b a k t ɛ r i
balau	b a l aʊ
bale	b a l ə
baleno	b a l ɛ n o
balfas	b a l f a s
bali	b a l i
balita	b a l i t a
bambang	b a m b a ŋ
bamus	b a m u s
banda	b a n d a
bandang	b a n d a ŋ
bandara	b a n d a r a
bandel-bandelnya	b a n d ə l b a n d ɛ l ɲ a
bandung	b a n d u ŋ
bang	b a ŋ
bangau	b a ŋ aʊ
banget	b a ŋ ə t
bangkok	b a ŋ k o k
bangsa	b a ŋ s a
bangunan	b a ŋ u n a n
banjir	b a n dʒ i r
bank	b a n k
bankir	b a n k i r
bantah	b a n t a h
banten	b a n t ə n
bantu	b a n t u
bantuan	b a n t u a n
banyak	b a ɲ a k
banyuputih	b a ɲ u p u t i h
banyuurip	b a ɲ u u r i p
banyuwangi	b a ɲ u w a ŋ i
banzer	b a n z ə r
bapak	b a p a k
bapakku	b a p a k k u
baramuli	b a r a m u l i
barang	b a r a ŋ
barang-barang	b a r a ŋ b a r a ŋ
baru	b a r u
barunya	b a r u ɲ a
basri	b a s r i
basyuni	b a ç u n i
batal	b a t a l
batalyon	b a t a l j o n
batam	b a t a m
batara	b a t a r a
batas	b a t a s
batasi	b a t a s i
batu	b a t u
batubara	b a t u b a r a
bau	b aʊ
bawa	b a w a
bawah	b a w a h
bawazier	b a w a z i r
bayar	b a j a r
bayer	b a j ə r
bayi	b a j i
bayi-bayi	b a j i b a j i
bayinya	b a j i ɲ a
bayu	b a j u
bazrif	b a z r i f
bea	b ɛ a
beban	b ɛ b a n
bebas	b ɛ b a s
beberapa	b ə b ə r a p a
becker	b ɛ tʃ k ə r
beckham	b ɛ tʃ x a m
becus	b ɛ tʃ u s
beda	b ɛ d a
bedanya	b ə d a ɲ a
beddu	b ɛ d d u
bedeng	b ɛ d ə ŋ
begini	b ə ɡ i n i
begitu	b ə ɡ i t u
bego	b ɛ ɡ o
beijing	b ə i dʒ i ŋ
bej	b ɛ dʒ
bejo	b ɛ dʒ o
bekal	b ɛ k a l
bekas	b ə k a s
beken	b ɛ k ə n
bekerja	b ə k ɛ r dʒ a
bel	b ɛ l
bela	b ɛ l a
belajar	b ə l a dʒ a r
belaka	b ə l a k a
belakang	b ə l a k a ŋ
belakangan	b ə l a k a ŋ a n
belanda	b ə l a n d a
belasan	b ə l a s a n
belati	b ə l a t i
belgia	b ə l ɡ i a
beliau	b ə l i aʊ
belokan	b ə l o k a n
belum	b ɛ l u m
bem	b ɛ m
benar	b ə n a r
benar-benar	b ə n a r b ə n a r
bendahara	b ə n d a h a r a
bendaharanya	b ə n d a h a r a ɲ a
bendera	b ə n d ɛ r a
bendot	b ə n d o t
bener	b ə n ɛ r
bengkel	b ə ŋ k ɛ l
bengong	b ə ŋ o ŋ
benih	b ə n i h
benjamin	b ə n dʒ a m i n
benowo	b ə n o w o
benteng	b ə n t ɛ ŋ
bentrok	b ə n t r o k
bentuk	b ə n t u k
bentuknya	b ə n t u k ɲ a
beo	b ɛ o
bepergian	b ə p ə r ɡ i a n
beracun	b ə r a tʃ u n
berada	b ə r a d a
berakhir	b ə r a x i r
beralih	b ə r a l i h
beraneka	b ə r a n ɛ k a
berangkat	b ə r a ŋ k a t
berani	b ə r a n i
berantakan	b ə r a n t a k a n
berapa	b ə r a p a
berargumen	b ə r a r ɡ u m ə n
berarti	b ə r a r t i
beras	b ɛ r a s
berasal	b ə r a s a l
berat	b ɛ r a t
berbadan	b ə r b a d a n
berbagai	b ə r b a ɡ aɪ
berbahasa	b ə r b a h a s a
berbahaya	b ə r b a h a j a
berbatasan	b ə r b a t a s a n
berbau	b ɛ r b aʊ
berbeda	b ə r b ɛ d a
berbeda-beda	b ə r b ɛ d a b ɛ d a
berbicara	b ə r b i tʃ a r a
berbintang	b ə r b i n t a ŋ
berbuat	b ə r b u a t
berbunyi	b ə r b u ɲ i
bercerai	b ə r tʃ ɛ r aɪ
berdamai	b ə r d a m aɪ
berdansa	b ə r d a n s a
berdasarkan	b ə r d a s a r k a n
berdatangan	b ə r d a t a ŋ a n
berdiri	b ə r d i r i
berdoa	b ə r d o a
berduyun-duyun	b ə r d u j u n d u j u n
berdzikir	b ə r d z i k i r
bereaksi	b ə r ə a k s i
beredar	b ə r ɛ d a r
berencana	b ə r ə n tʃ a n a
berfluktuasi	b ə r f l u k t u a s i
berfungsi	b ə r f u ŋ s i
bergaris	b ə r ɡ a r i s
bergaul	b ɛ r ɡ aʊ l
bergegas	b ə r ɡ ɛ ɡ a s
bergerak	b ə r ɡ ɛ r a k
bergetar	b ə r ɡ ɛ t a r
berguna	b ə r ɡ u n a
berharap	b ə r h a r a p
berhasil	b ə r h a s i l
berhati-hati	b ə r h a t i h a t i
berhenti	b ə r h ɛ n t i
beri	b ɛ r i
berikut	b ə r i k u t
beriman	b ə r i m a n
berjaga	b ə r dʒ a ɡ a
berjalan	b ə r dʒ a l a n
berjamaah	b ə r dʒ a m a a h
berjangka	b ə r dʒ a ŋ k a
berjanji	b ə r dʒ a n dʒ i
berjenis	b ə r dʒ ɛ n i s
berkaca-kaca	b ə r k a tʃ a k a tʃ a
berkala	b ə r k a l a
berkali-kali	b ə r k a l i k a l i
berkata	b ə r k a t a
berkelit	b ə r k ɛ l i t
berkeriput	b ə r k ə r i p u t
berkhianat	b ə r x i a n a t
berkomentar	b ə r k o m ɛ n t a r
berkonspirasi	b ə r k o n s p i r a s i
berkonsultasi	b ə r k o n s u l t a s i
berkonvoi	b ə r k o n v o i
berkuasa	b ə r k u a s a
berkumpul	b ə r k u m p u l
berkurang	b ə r k u r a ŋ
berlaku	b ə r l a k u
berlalu	b ə r l a l u
berlangsung	b ə r l a ŋ s u ŋ
berlari	b ə r l a r i
berlendir	b ə r l ɛ n d i r
berlogo	b ə r l o ɡ o
bermain	b ɛ r m aɪ n
bermaksud	b ə r m a k s u d
bermasalah	b ə r m a s a l a h
bermata	b ə r m a t a
bermodal	b ə r m o d a l
bermotor	b ə r m o t ɔ r
bermula	b ə r m u l a
bernama	b ə r n a m a
berniat	b ə r n i a t
bernilai	b ə r n i l aɪ
bernuansa	b ə r n u a n s a
bernyanyi	b ə r ɲ a ɲ i
beroperasi	b ə r o p ə r a s i
berpendapat	b ə r p ə n d a p a t
berperan	b ə r p ɛ r a n
berperang	b ə r p ɛ r a ŋ
bersalah	b ə r s a l a h
bersama	b ə r s a m a
bersama-sama	b ə r s a m a s a m a
bersatu	b ə r s a t u
bersedia	b ə r s ə d i a
bersenda	b ə r s ɛ n d a
bersenjata	b ə r s ə n dʒ a t a
bersepeda	b ə r s ə p ɛ d a
berseragam	b ə r s ə r a ɡ a m
bersifat	b ə r s i f a t
bersih	b ɛ r s i h
bersikap	b ə r s i k a p
bersikeras	b ə r s i k ɛ r a s
bersimbah	b ə r s i m b a h
berskala	b ə r s k a l a
bersprei	b ə r s p r ɛ i
bersujud	b ə r s u dʒ u d
bersyukur	b ə r ç u k u r
bertahan	b ə r t a h a n
bertambah	b ə r t a m b a h
bertanding	b ə r t a n d i ŋ
bertanggung	b ə r t a ŋ ɡ u ŋ
bertanya	b ə r t a ɲ a
bertele-tele	b ə r t ɛ l ə t ə l ɛ
bertemu	b ə r t ɛ m u
bertenaga	b ə r t ə n a ɡ a
bertengkar	b ə r t ɛ ŋ k a r
bertikai	b ə r t i k aɪ
bertindak	b ə r t i n d a k
bertipe	b ə r t i p ə
bertolak	b ə r t o l a k
bertukar	b ə r t u k a r
bertuliskan	b ə r t u l i s k a n
berubah	b ə r u b a h
berubah-ubah	b ə r u b a h u b a h
berujar	b ə r u dʒ a r
beruntung	b ə r u n t u ŋ
berupa	b ə r u p a
berusaha	b ə r u s a h a
berwarna	b ə r w a r n a
berwenang	b ə r w ɛ n a ŋ
berwujud	b ə r w u dʒ u d
berziarah	b ə r z i a r a h
besar	b ɛ s a r
beserta	b ə s ɛ r t a
besok	b ɛ s o k
betapa	b ə t a p a
betawi	b ə t a w i
bethany	b ə t h a ɲ
betul	b ɛ t u l
betul-betul	b ɛ t u l b ɛ t u l
bharada	b h a r a d a
bi	b i
biar	b i a r
biasa	b i a s a
biasanya	b i a s a ɲ a
biaya	b i a j a
bibit	b i b i t
bicara	b i tʃ a r a
bicaranya	b i tʃ a r a ɲ a
bidang	b i d a ŋ
bidangnya	b i d a ŋ ɲ a
bii	b i i
bijak	b i dʒ a k
biji	b i dʒ i
biji-biji	b i dʒ i b i dʒ i
biki	b i k i
bikin	b i k i n
bila	b i l a
bilang	b i l a ŋ
bilyet	b i l j ə t
bimantoro	b i m a n t ɔ r o
bimoli	b i m o l i
bina	b i n a
bingung	b i ŋ u ŋ
binjai	b i n dʒ aɪ
bintang	b i n t a ŋ
biografi	b i o ɡ r a f i
biohanis	b i o h a n i s
bioskop	b i o s k o p
bireuen	b i r ə u ə n
biro	b i r o
birokrasi	b i r o k r a s i
biru	b i r u
bisa	b i s a
bisnisnya	b i s n i s ɲ a
bisri	b i s r i
bius	b i u s
blak-blakan	b l a k b l a k a n
blanko	b l a n k o
blitar	b l i t a r
blok	b l o k
blok-m	b l o k ɛ m
blokade	b l o k a d ə
blong	b l o ŋ
blora	b l ɔ r a
boalemo	b o a l ɛ m o
bob	b o b
bocah	b o tʃ a h
bogor	b o ɡ ɔ r
boikot	b o i k o t
bojonegoro	b o dʒ o n ə ɡ ɔ r o
boks	b o k s
bola	b o l a
boleh	b o l ə h
boleh-boleh	b o l ə h b o l ə h
bom	b o m
bomnya	b o m ɲ a
bondowoso	b o n d o w o s o
bongkar	b o ŋ k a r
bopunjur	b o p u n dʒ u r
bosan	b o s a n
bosnia	b o s n i a
bosnya	b o s ɲ a
botol	b o t o l
bowo	b o w o
braile	b r aɪ l ə
brankas	b r a n k a s
brantas	b r a n t a s
brasil	b r a s i l
brebes	b r ɛ b ə s
brenda	b r ɛ n d a
brian	b r i a n
brigade	b r i ɡ a d ə
brigjen	b r i ɡ dʒ ə n
brimob	b r i m o b
bromo	b r o m o
brunaigate	b r u n aɪ ɡ a t ə
brunei	b r u n ɛ i
bruneigate	b r u n ə i ɡ a t ə
brussels	b r u s ə l s
bu	b u
buah	b u a h
buatan	b u a t a n
buchori	b u χ ɔ r i
budaya	b u d a j a
budha	b u d h a
budi	b u d i
budiono	b u d i o n o
budjeter	b u dʒ ɛ t ə r
bujeter	b u dʒ ɛ t ə r
bujuk	b u dʒ u k
bukan	b u k a n
bukankah	b u k a n k a h
bukanlah	b u k a n l a h
bukannya	b u k a n ɲ a
bukit	b u k i t
bukittinggi	b u k i t t i ŋ ɡ i
bukti	b u k t i
buku	b u k u
bukunya	b u k u ɲ a
bulan	b u l a n
buldozer	b u l d o z ə r
bulog	b u l o ɡ
bulogate	b u l o ɡ a t ə
buloggate	b u l o ɡ ɡ a t ə
buloggate-bruneigate	b u l o ɡ ɡ a t ə b r u n ə i ɡ a t ə
bumerang	b u m ɛ r a ŋ
bumi	b u m i
bumn	b u m n
bung	b u ŋ
bunga	b u ŋ a
bungkam	b u ŋ k a m
bungo	b u ŋ o
buntet	b u n t ə t
buntul	b u n t u l
bunuh	b u n u h
bunyi	b u ɲ i
bunyu	b u ɲ u
bupati	b u p a t i
burhanuddin	b u r h a n u d d i n
burnham	b u r n h a m
buron	b u r o n
bursa	b u r s a
burung	b u r u ŋ
bus	b u s
bush	b u s h
busri	b u s r i
busuk	b u s u k
butet	b u t ə t
butir	b u t i r
buton	b u t o n
butuh	b u t u h
buyung	b u j u ŋ
cabang	tʃ a b a ŋ
cabang-cabang	tʃ a b a ŋ tʃ a b a ŋ
cabe	tʃ a b ə
cabut	tʃ a b u t
cacuk	tʃ a tʃ u k
cadangan	tʃ a d a ŋ a n
cadangannya	tʃ a d a ŋ a n ɲ a
cahyono	tʃ a h j o n o
cair	tʃ aɪ r
cakrawala	tʃ a k r a w a l a
cakrawerdaya	tʃ a k r a w ə r d a j a
cakung	tʃ a k u ŋ
calo-calo	tʃ a l o tʃ a l o
calon	tʃ a l o n
calonnya	tʃ a l o n ɲ a
camat	tʃ a m a t
canang	tʃ a n a ŋ
cantik	tʃ a n t i k
capai	tʃ a p aɪ
capek	tʃ a p ə k
cara	tʃ a r a
caranya	tʃ a r a ɲ a
cari	tʃ a r i
carrascalao	tʃ a r a s tʃ a l a o
carsten	tʃ a r s t ə n
catatan	tʃ a t a t a n
catur	tʃ a t u r
cawang-tomang-pluit	tʃ a w a ŋ t o m a ŋ p l u i t
ceburkan	tʃ ə b u r k a n
cece	tʃ ɛ tʃ ə
cecep	tʃ ɛ tʃ ə p
cedera	tʃ ə d ɛ r a
cek	tʃ ɛ k
cekcok	tʃ ɛ k tʃ o k
ceko	tʃ ɛ k o
celah	tʃ ɛ l a h
celana	tʃ ə l a n a
celancang	tʃ ə l a n tʃ a ŋ
cemerlang	tʃ ə m ɛ r l a ŋ
cencen	tʃ ɛ n tʃ ə n
cendana	tʃ ə n d a n a
cendekiawan	tʃ ɛ n d ə k i a w a n
cenderawasih	tʃ ɛ n d ə r a w a s i h
cenderung	tʃ ə n d ɛ r u ŋ
cendol	tʃ ɛ n d o l
cengeng	tʃ ɛ ŋ ə ŋ
cengkareng	tʃ ə ŋ k a r ə ŋ
cengkeh	tʃ ɛ ŋ k ə h
cengkehnya	tʃ ə ŋ k ɛ h ɲ a
cepat	tʃ ɛ p a t
ceplas-ceplos	tʃ ɛ p l a s tʃ ɛ p l o s
cerah	tʃ ɛ r a h
ceramah	tʃ ə r a m a h
cerdas	tʃ ɛ r d a s
cerdik	tʃ ɛ r d i k
ceria	tʃ ə r i a
cerita	tʃ ə r i t a
cetak	tʃ ɛ t a k
chaerudin	χ a ə r u d i n
chaerul	χ a ɛ r u l
chandra	χ a n d r a
china	χ i n a
choi	χ o i
choirie	χ o i r i
choirudin	χ o i r u d i n
choirul	χ o i r u l
cholid	χ o l i d
cholil	χ o l i l
chomsyah	χ o m ç a h
chotibul	χ o t i b u l
christine	χ r i s t i n ə
chrisye	χ r i ç ə
ciamis	tʃ i a m i s
cianjur	tʃ i a n dʒ u r
cibeureum	tʃ i b ə u r ɛ u m
cibinong	tʃ i b i n o ŋ
cicit	tʃ i tʃ i t
cideng	tʃ i d ə ŋ
cidera	tʃ i d ɛ r a
ciganjur	tʃ i ɡ a n dʒ u r
cihideung	tʃ i h i d ɛ u ŋ
cijantung	tʃ i dʒ a n t u ŋ
cikarang	tʃ i k a r a ŋ
cilacap	tʃ i l a tʃ a p
cilangkap	tʃ i l a ŋ k a p
ciledug	tʃ i l ɛ d u ɡ
cileungsi	tʃ i l ə u ŋ s i
cilik	tʃ i l i k
cilincing	tʃ i l i n tʃ i ŋ
cina	tʃ i n a
cincin	tʃ i n tʃ i n
cinta	tʃ i n t a
cipacing	tʃ i p a tʃ i ŋ
ciparugpug	tʃ i p a r u ɡ p u ɡ
cipete	tʃ i p ɛ t ə
cipta	tʃ i p t a
ciptakan	tʃ i p t a k a n
ciputra	tʃ i p u t r a
cirebon	tʃ i r ɛ b o n
cisauk	tʃ i s aʊ k
citeureup	tʃ i t ə u r ɛ u p
citra	tʃ i t r a
clurit	tʃ l u r i t
coba	tʃ o b a
cocok	tʃ o tʃ o k
cokelat	tʃ o k ɛ l a t
coklat	tʃ o k l a t
condong	tʃ o n d o ŋ
contoh	tʃ o n t o h
contoh-contoh	tʃ o n t o h tʃ o n t o h
contohnya	tʃ o n t o h ɲ a
corat-coret	tʃ ɔ r a t tʃ ɔ r ə t
coret-coretnya	tʃ ɔ r ə t tʃ ɔ r ɛ t ɲ a
cowok	tʃ o w o k
cubitan	tʃ u b i t a n
cuci	tʃ u tʃ i
cucu	tʃ u tʃ u
cucunya	tʃ u tʃ u ɲ a
cuekin	tʃ u ɛ k i n
cukai	tʃ u k aɪ
cukup	tʃ u k u p
culik	tʃ u l i k
cuma	tʃ u m a
curah	tʃ u r a h
curiga	tʃ u r i ɡ a
curug	tʃ u r u ɡ
cuti	tʃ u t i
daerah	d a ɛ r a h
daerah-daerah	d a ɛ r a h d a ɛ r a h
daftar	d a f t a r
daging	d a ɡ i ŋ
dahi	d a h i
dai	d aɪ
dalam	d a l a m
damai	d a m aɪ
damainya	d a m aɪ ɲ a
damiri	d a m i r i
dampak	d a m p a k
damsyik	d a m ç i k
dan	d a n
dana	d a n a
danau	d a n aʊ
danyon	d a ɲ o n
dapat	d a p a t
darah	d a r a h
darat	d a r a t
daratan	d a r a t a n
darham	d a r h a m
dari	d a r i
daripada	d a r i p a d a
darmansyah	d a r m a n ç a h
darmono	d a r m o n o
darurat	d a r u r a t
darussalam	d a r u s a l a m
darwis	d a r w i s
dasar	d a s a r
dasarnya	d a s a r ɲ a
data	d a t a
datang	d a t a ŋ
daud	d aʊ d
davenport	d a v ɛ n p ɔ r t
david	d a v i d
davids	d a v i d s
davidson	d a v i d s o n
dawai	d a w aɪ
dawuan	d a w u a n
dawuhan	d a w u h a n
daya	d a j a
dayeuhkolot	d a j ə u h k o l o t
dayeuhluhur	d a j ə u h l u h u r
debu	d ɛ b u
deda	d ɛ d a
defile	d ə f i l ə
deflasi	d ə f l a s i
deh	d ɛ h
dekat	d ɛ k a t
dekrit	d ɛ k r i t
delapan	d ə l a p a n
demi	d ɛ m i
demikian	d ɛ m i k i a n
demokrasi	d ɛ m o k r a s i
demonstrasi	d ɛ m o n s t r a s i
dengan	d ɛ ŋ a n
dengar	d ɛ ŋ a r
denmark	d ɛ n m a r k
denpasar	d ə n p a s a r
deny	d ɛ ɲ
denyut	d ɛ ɲ u t
depag	d ɛ p a ɡ
depan	d ɛ p a n
departemen	d ɛ p a r t ɛ m ə n
dephubtel	d ə f u b t ə l
dephut	d ɛ f u t
depkeh	d ɛ p k ə h
depkeu	d ə p k ɛ u
deplu	d ɛ p l u
depnaker	d ə p n a k ə r
depnakertrans	d ɛ p n a k ɛ r t r a n s
deretan	d ə r ɛ t a n
desa	d ɛ s a
desain	d ɛ s aɪ n
desember	d ə s ɛ m b ə r
destabilisasi	d ɛ s t a b i l i s a s i
destruktif	d ə s t r u k t i f
detail	d ɛ t aɪ l
detailnya	d ə t aɪ l ɲ a
detil	d ɛ t i l
developer	d ɛ v ə l o p ə r
devisa	d ə v i s a
dewa	d ɛ w a
dewan	d ɛ w a n
dewi	d ɛ w i
dharmala	d h a r m a l a
di	d i
dia	d i a
diadakan	d i a d a k a n
diagnosa	d i a ɡ n o s a
diajak	d i a dʒ a k
diaktifkan	d i a k t i f k a n
diakui	d i a k u i
diakuinya	d i a k u i ɲ a
dialami	d i a l a m i
dialihkan	d i a l i h k a n
dialog	d i a l o ɡ
diam	d i a m
diam-diam	d i a m d i a m
dianalisa	d i a n a l i s a
dianggap	d i a ŋ ɡ a p
diantaranya	d i a n t a r a ɲ a
diantarkan	d i a n t a r k a n
diantisipasi	d i a n t i s i p a s i
diarahkan	d i a r a h k a n
diartikan	d i a r t i k a n
diasuh	d i a s u h
diawasi	d i a w a s i
dibaca	d i b a tʃ a
dibacok	d i b a tʃ o k
dibagi	d i b a ɡ i
dibahas	d i b a h a s
dibaiat	d i b aɪ a t
dibakar	d i b a k a r
dibanding	d i b a n d i ŋ
dibantah	d i b a n t a h
dibantai	d i b a n t aɪ
dibatasi	d i b a t a s i
dibawa	d i b a w a
dibawah	d i b a w a h
dibayar	d i b a j a r
dibayarkan	d i b a j a r k a n
dibebaskan	d i b ə b a s k a n
dibekukan	d i b ə k u k a n
dibenahi	d i b ə n a h i
dibenci	d i b ə n tʃ i
dibentuk	d i b ə n t u k
diberi	d i b ɛ r i
diberikan	d i b ə r i k a n
dibicarakan	d i b i tʃ a r a k a n
dibilang	d i b i l a ŋ
diblokade	d i b l o k a d ə
diblokir	d i b l o k i r
diboikot	d i b o i k o t
dibonceng	d i b o n tʃ ə ŋ
diborgol	d i b ɔ r ɡ o l
dibuat	d i b u a t
dibubarkan	d i b u b a r k a n
dibuka	d i b u k a
dibungkus	d i b u ŋ k u s
dibunyikan	d i b u ɲ i k a n
dicecar	d i tʃ ɛ tʃ a r
dicopot	d i tʃ o p o t
diculik	d i tʃ u l i k
dicuri	d i tʃ u r i
didampingi	d i d a m p i ŋ i
didapat	d i d a p a t
didik	d i d i k
didirikan	d i d i r i k a n
didrop	d i d r o p
diduga	d i d u ɡ a
didukung	d i d u k u ŋ
diekspor	d i k s p ɔ r
dielu-elukan	d i l u ə l u k a n
dieng	d i ŋ
diet	d i t
diganti	d i ɡ a n t i
digebukin	d i ɡ ə b u k i n
digelar	d i ɡ ɛ l a r
digelari	d i ɡ ə l a r i
digerebek	d i ɡ ə r ɛ b ə k
digeser	d i ɡ ɛ s ə r
digunakan	d i ɡ u n a k a n
digunting	d i ɡ u n t i ŋ
dihadapkan	d i h a d a p k a n
dihalau	d i h a l aʊ
dihambat	d i h a m b a t
diharapkan	d i h a r a p k a n
dihimbau	d i h i m b aʊ
dihindarkan	d i h i n d a r k a n
dihitung	d i h i t u ŋ
dihubungi	d i h u b u ŋ i
diijinkan	d i i dʒ i n k a n
diimbau	d i i m b aʊ
diingat	d i i ŋ a t
diiringi	d i i r i ŋ i
dijadikan	d i dʒ a d i k a n
dijadwalkan	d i dʒ a d w a l k a n
dijaga	d i dʒ a ɡ a
dijalankan	d i dʒ a l a n k a n
dijangkau	d i dʒ a ŋ k aʊ
dijatuhkan	d i dʒ a t u h k a n
dijelaskan	d i dʒ ə l a s k a n
dijemput	d i dʒ ɛ m p u t
dijual	d i dʒ u a l
dijuluki	d i dʒ u l u k i
dikapling	d i k a p l i ŋ
dikatakan	d i k a t a k a n
dikawal	d i k a w a l
dikelola	d i k ə l o l a
dikemudikan	d i k ə m u d i k a n
dikemukakan	d i k ə m u k a k a n
dikenal	d i k ə n a l
dikerjakan	d i k ə r dʒ a k a n
dikeroyok	d i k ə r o j o k
diketahui	d i k ə t a h u i
diketuai	d i k ə t u aɪ
dikhawatirkan	d i x a w a t i r k a n
dikonfirmasikan	d i k o n f i r m a s i k a n
dikutip	d i k u t i p
dilakukan	d i l a k u k a n
dilalap	d i l a l a p
dilanda	d i l a n d a
dilempari	d i l ə m p a r i
dilepas	d i l ɛ p a s
dilepaskan	d i l ə p a s k a n
dilerai	d i l ɛ r aɪ
dilihat	d i l i h a t
dimakamkan	d i m a k a m k a n
dimaksud	d i m a k s u d
dimaksudkan	d i m a k s u d k a n
dimaksudnya	d i m a k s u d ɲ a
dimasukkan	d i m a s u k k a n
dimatikan	d i m a t i k a n
dimenangi	d i m ə n a ŋ i
diminta	d i m i n t a
dimuat	d i m u a t
dimulai	d i m u l aɪ
dimulainya	d i m u l aɪ ɲ a
dinas	d i n a s
dingin	d i ŋ i n
dinilai	d i n i l aɪ
dinilainya	d i n i l aɪ ɲ a
dinyatakan	d i ɲ a t a k a n
dipagari	d i p a ɡ a r i
dipakai	d i p a k aɪ
dipaksa	d i p a k s a
dipandu	d i p a n d u
dipanggil	d i p a ŋ ɡ i l
dipasang	d i p a s a ŋ
dipegang	d i p ɛ ɡ a ŋ
dipengaruhi	d i p ə ŋ a r u h i
dipenuhi	d i p ə n u h i
dipenuhinya	d i p ə n u h i ɲ a
diperbolehkan	d i p ə r b o l ɛ h k a n
diperiksa	d i p ə r i k s a
diperjuangkan	d i p ə r dʒ u a ŋ k a n
diperkuat	d i p ə r k u a t
diperlakukan	d i p ə r l a k u k a n
diperlukan	d i p ə r l u k a n
diperoleh	d i p ə r o l ə h
dipersiapkan	d i p ə r s i a p k a n
dipersilahkan	d i p ə r s i l a h k a n
dipertanggungjawabkan	d i p ə r t a ŋ ɡ u ŋ dʒ a w a b k a n
diperuntukkan	d i p ə r u n t u k k a n
dipicu	d i p i tʃ u
dipimpin	d i p i m p i n
dipindah	d i p i n d a h
dipindahkan	d i p i n d a h k a n
diplomatik	d i p l o m a t i k
dipo	d i p o
diponegoro	d i p o n ə ɡ ɔ r o
dipotong	d i p o t o ŋ
dipublikasikan	d i p u b l i k a s i k a n
dipulangkan	d i p u l a ŋ k a n
dipulihkan	d i p u l i h k a n
dipusatkan	d i p u s a t k a n
diragukan	d i r a ɡ u k a n
diraih	d i r aɪ h
dirakit	d i r a k i t
dirancang	d i r a n tʃ a ŋ
direktur	d i r ɛ k t u r
diresmikan	d i r ə s m i k a n
direstrukturisasi	d i r ə s t r u k t u r i s a s i
direview	d i r ɛ v i w
direvisi	d i r ə v i s i
diri	d i r i
dirimu	d i r i m u
dirintis	d i r i n t i s
dirjen	d i r dʒ ə n
dirugikan	d i r u ɡ i k a n
dirut	d i r u t
disajikan	d i s a dʒ i k a n
disalahgunakan	d i s a l a h ɡ u n a k a n
disambut	d i s a m b u t
disampaikan	d i s a m p aɪ k a n
disatroni	d i s a t r o n i
disebabkan	d i s ə b a b k a n
disebarkan	d i s ə b a r k a n
disebut	d i s ɛ b u t
disebutkan	d i s ə b u t k a n
disegani	d i s ə ɡ a n i
disela-sela	d i s ɛ l a s ɛ l a
diselesaikan	d i s ə l ə s aɪ k a n
diserahkan	d i s ə r a h k a n
diserang	d i s ɛ r a ŋ
diserbu	d i s ɛ r b u
disertai	d i s ɛ r t aɪ
disewa	d i s ɛ w a
disiapkan	d i s i a p k a n
disiarkan	d i s i a r k a n
disinggung	d i s i ŋ ɡ u ŋ
disiplin	d i s i p l i n
disita	d i s i t a
diskenario	d i s k ə n a r i o
disokong	d i s o k o ŋ
disulap	d i s u l a p
disuplai	d i s u p l aɪ
disuruh	d i s u r u h
ditafsirkan	d i t a f s i r k a n
ditahan	d i t a h a n
ditandai	d i t a n d aɪ
ditangkap	d i t a ŋ k a p
ditanya	d i t a ɲ a
ditanyai	d i t a ɲ aɪ
ditayangkan	d i t a j a ŋ k a n
ditebus	d i t ɛ b u s
ditembak	d i t ɛ m b a k
ditempuh	d i t ɛ m p u h
ditemukan	d i t ə m u k a n
ditemukannya	d i t ə m u k a n ɲ a
ditengarai	d i t ə ŋ a r aɪ
ditentukan	d i t ə n t u k a n
diterapkan	d i t ə r a p k a n
diterbangkan	d i t ə r b a ŋ k a n
diterbitkan	d i t ə r b i t k a n
diterima	d i t ə r i m a
diteruskan	d i t ə r u s k a n
ditetapkannya	d i t ə t a p k a n ɲ a
ditindak	d i t i n d a k
ditinjau	d i t i n dʒ aʊ
ditjen	d i tʃ ə n
ditolak	d i t o l a k
dituai	d i t u aɪ
dituangkan	d i t u a ŋ k a n
dituduh	d i t u d u h
ditujukan	d i t u dʒ u k a n
ditulis	d i t u l i s
ditunda	d i t u n d a
dituntaskan	d i t u n t a s k a n
ditutup	d i t u t u p
diubah	d i u b a h
diumumkan	d i u m u m k a n
diungkapkan	d i u ŋ k a p k a n
diuntungkan	d i u n t u ŋ k a n
divisi	d i v i s i
divonis	d i v o n i s
diy	d i j
diyakini	d i j a k i n i
djaelani	dʒ a ə l a n i
djakfar	dʒ a k f a r
djali	dʒ a l i
dki	d k i
dllaj	d l a dʒ
doang	d o a ŋ
dodi	d o d i
dodo	d o d o
dokter	d o k t ə r
dokumen	d o k u m ə n
dollar	d o l a r
domestik	d o m ɛ s t i k
dominan	d o m i n a n
dong	d o ŋ
doni	d o n i
dorojatun	d ɔ r o dʒ a t u n
dpr	d e p e ə r
dprd	d e p e ə r d e
dpw	d e p e w e
dradjat	d r a dʒ a t
draf	d r a f
drainase	d r aɪ n a s ə
drajad	d r a dʒ a d
drajat	d r a dʒ a t
drama	d r a m a
dramatis	d r a m a t i s
drastis	d r a s t i s
drum	d r u m
dua	d u a
dubes	d u b ə s
duduk	d u d u k
duel	d u ə l
dufan	d u f a n
dugaan	d u ɡ a a n
dukung	d u k u ŋ
dukungan	d u k u ŋ a n
dulu	d u l u
dulunya	d u l u ɲ a
dunia	d u n i a
dupa	d u p a
dur	d u r
dusun	d u s u n
duta	d u t a
dwifungsi	d w i f u ŋ s i
dwikarna	d w i k a r n a
dwipa	d w i p a
dwipangga	d w i p a ŋ ɡ a
dwitunggal	d w i t u ŋ ɡ a l
dwiyanto	d w i j a n t o
dzuhur	d z u h u r
dzulhijjah	d z u l h i dʒ dʒ a h
e-mail	e m aɪ l
ebtanas	ə b t a n a s
eceran	ə tʃ ɛ r a n
eddy	ɛ d d j
eddyartono	ɛ d d j a r t o n o
edgar	ɛ d ɡ a r
edi	ɛ d i
edisi	ə d i s i
editor	ə d i t ɔ r
eduardo	ɛ d u a r d o
edwin	ɛ d w i n
edy	ɛ d j
efeknya	ə f ɛ k ɲ a
efektif	ə f ɛ k t i f
effendi	ə f ɛ n d i
effendy	ɛ f ə n d j
eforia	ɛ f ɔ r i a
ega	ɛ ɡ a
egaliter	ɛ ɡ a l i t ə r
egi	ɛ ɡ i
ego	ɛ ɡ o
egoisme	ɛ ɡ o i s m ə
eh	ɛ h
ejaan	ə dʒ a a n
ejek	ɛ dʒ ə k
ejekan	ə dʒ ɛ k a n
eki	ɛ k i
eko	ɛ k o
ekonom	ə k o n o m
ekonomi	ɛ k o n o m i
eks	ɛ k s
eksekutif	ɛ k s ə k u t i f
eksekutor	ɛ k s ə k u t ɔ r
eksklusif	ə k s k l u s i f
ekspansi	ə k s p a n s i
eksperimental	ɛ k s p ə r i m ɛ n t a l
eksplosif	ə k s p l o s i f
ekspor	ɛ k s p ɔ r
ekspres	ɛ k s p r ə s
ekstern	ɛ k s t ə r n
ekuin	ə k u i n
elang	ɛ l a ŋ
elektrindo	ɛ l ə k t r i n d o
elektro	ə l ɛ k t r o
elisa	ə l i s a
elit	ɛ l i t
elite	ə l i t ə
elsa	ɛ l s a
elshinta	ə l s h i n t a
elsya	ɛ l ç a
elvis	ɛ l v i s
elza	ɛ l z a
emanuel	ɛ m a n u ə l
emas	ɛ m a s
embargo	ə m b a r ɡ o
embong	ɛ m b o ŋ
emir	ɛ m i r
emmy	ɛ m m j
emosi	ə m o s i
empat	ɛ m p a t
empat-lima	ɛ m p a t l i m a
empuk	ɛ m p u k
enak	ɛ n a k
enam	ɛ n a m
endah	ɛ n d a h
endang	ɛ n d a ŋ
endemik	ə n d ɛ m i k
endriartono	ɛ n d r i a r t o n o
energi	ə n ɛ r ɡ i
enggak	ɛ ŋ ɡ a k
enggan	ɛ ŋ ɡ a n
enggar	ɛ ŋ ɡ a r
engkos	ɛ ŋ k o s
enjam	ɛ n dʒ a m
enjang	ɛ n dʒ a ŋ
entah	ɛ n t a h
entahlah	ə n t a h l a h
enteng	ɛ n t ə ŋ
entoy	ɛ n t o j
epilepsi	ɛ p i l ɛ p s i
episentrum	ɛ p i s ɛ n t r u m
episode	ɛ p i s o d ə
era	ɛ r a
erat	ɛ r a t
eric	ɛ r i tʃ
ermita	ə r m i t a
eropa	ə r o p a
erry	ɛ r r j
erwin	ɛ r w i n
esai	ɛ s aɪ
esok	ɛ s o k
ester	ɛ s t ə r
estrada	ə s t r a d a
etik	ɛ t i k
etnis	ɛ t n i s
etnisitas	ɛ t n i s i t a s
eulis	ə u l i s
euphoria	ɛ u f ɔ r i a
eurasia	ɛ u r a s i a
eurico	ɛ u r i tʃ o
euthanasia	ɛ u t h a n a s i a
evakuasi	ɛ v a k u a s i
evaluasi	ɛ v a l u a s i
evi	ɛ v i
eyang	ɛ j a ŋ
fachmi	f a χ m i
fachri	f a χ r i
fadel	f a d ə l
fadhillah	f a d h i l a h
fadri	f a d r i
fahim	f a h i m
fahmi	f a h m i
faisal	f aɪ s a l
faiz	f aɪ z
fajar	f a dʒ a r
fajri	f a dʒ r i
fakhruddin	f a x r u d d i n
fakta	f a k t a
faktor	f a k t ɔ r
faktor-faktor	f a k t ɔ r f a k t ɔ r
fans	f a n s
farhan	f a r h a n
farikha	f a r i x a
fariz	f a r i z
farma	f a r m a
fase	f a s ə
fasih	f a s i h
fasilitas	f a s i l i t a s
fasilitator	f a s i l i t a t ɔ r
fathur	f a t h u r
fatmawati	f a t m a w a t i
fatwa	f a t w a
fauzi	f aʊ z i
favorit	f a v ɔ r i t
fazil	f a z i l
febi	f ɛ b i
federal	f ə d ɛ r a l
feisal	f ə i s a l
felix	f ɛ l i k s
feng	f ɛ ŋ
fenomena	f ɛ n o m ɛ n a
feodalisme	f ɛ o d a l i s m ə
ferdinand	f ə r d i n a n d
ferdinandus	f ɛ r d i n a n d u s
feri	f ɛ r i
ferrari	f ə r a r i
ferry	f ɛ r r j
figur	f i ɡ u r
fihak	f i h a k
fikri	f i k r i
fila	f i l a
filipina	f i l i p i n a
film	f i l m
filmnya	f i l m ɲ a
filosofi	f i l o s o f i
final	f i n a l
finansial	f i n a n s i a l
finarwanto	f i n a r w a n t o
firaun	f i r aʊ n
firman	f i r m a n
firmansyah	f i r m a n ç a h
fisik	f i s i k
fisip	f i s i p
fitnah	f i t n a h
fitri	f i t r i
flat	f l a t
fleksibel	f l ə k s i b ə l
flores	f l ɔ r ə s
florida	f l ɔ r i d a
flu	f l u
foil	f o i l
fokus	f o k u s
formatnya	f ɔ r m a t ɲ a
formula	f ɔ r m u l a
forum	f ɔ r u m
foto	f o t o
fotografer	f o t o ɡ r a f ə r
foya-foya	f o j a f o j a
fpdip	f p d i p
fragmentasi	f r a ɡ m ə n t a s i
fraksi	f r a k s i
fraksi-fraksi	f r a k s i f r a k s i
francisco	f r a n tʃ i s tʃ o
frankfurt	f r a n k f u r t
frans	f r a n s
fransisca	f r a n s i s tʃ a
fransiskus	f r a n s i s k u s
fred	f r ɛ d
frekuensi	f r ɛ k u ɛ n s i
frits	f r i t s
front	f r o n t
frustrasi	f r u s t r a s i
fuad	f u a d
fuedi	f u ɛ d i
fujiwara	f u dʒ i w a r a
fundamentalis	f u n d a m ə n t a l i s
fundamentalisme	f u n d a m ɛ n t a l i s m ə
fungsi	f u ŋ s i
fungsionaris	f u ŋ s i o n a r i s
futsal	f u t s a l
fuzi	f u z i
gade	ɡ a d ə
gadis	ɡ a d i s
gafar	ɡ a f a r
gagal	ɡ a ɡ a l
gaji	ɡ a dʒ i
gali	ɡ a l i
gam	ɡ a m
gambir	ɡ a m b i r
gampang	ɡ a m p a ŋ
gani	ɡ a n i
ganja	ɡ a n dʒ a
ganteng	ɡ a n t ə ŋ
gara-gara	ɡ a r a ɡ a r a
garam	ɡ a r a m
garin	ɡ a r i n
garis	ɡ a r i s
garnisun	ɡ a r n i s u n
garnizun	ɡ a r n i z u n
garuda	ɡ a r u d a
garut	ɡ a r u t
gas	ɡ a s
gatot	ɡ a t o t
gawang	ɡ a w a ŋ
gaya	ɡ a j a
gayo	ɡ a j o
gaza	ɡ a z a
gebyar	ɡ ɛ b j a r
gede	ɡ ɛ d ə
gedong	ɡ ɛ d o ŋ
gedung	ɡ ɛ d u ŋ
geger	ɡ ɛ ɡ ə r
gejala	ɡ ə dʒ a l a
gejolak	ɡ ə dʒ o l a k
gelap	ɡ ɛ l a p
gelombang	ɡ ə l o m b a ŋ
gemala	ɡ ə m a l a
gembira	ɡ ə m b i r a
gemercik	ɡ ə m ɛ r tʃ i k
gemerlap	ɡ ə m ɛ r l a p
gemilang	ɡ ə m i l a ŋ
gempa	ɡ ɛ m p a
gemuk	ɡ ɛ m u k
gen	ɡ ɛ n
gencar	ɡ ɛ n tʃ a r
gendut	ɡ ɛ n d u t
genggam	ɡ ɛ ŋ ɡ a m
gengsi	ɡ ɛ ŋ s i
gentar	ɡ ɛ n t a r
geo	ɡ ɛ o
geo-ekonomi	ɡ ɛ o ɛ k o n o m i
geofisika	ɡ ɛ o f i s i k a
geografis	ɡ ɛ o ɡ r a f i s
geografisnya	ɡ ɛ o ɡ r a f i s ɲ a
gepeng	ɡ ɛ p ə ŋ
gepokan	ɡ ə p o k a n
gerai-gerai	ɡ ɛ r aɪ ɡ ɛ r aɪ
gerak	ɡ ɛ r a k
gerakan	ɡ ə r a k a n
gerbong	ɡ ɛ r b o ŋ
gereja	ɡ ə r ɛ dʒ a
ghozali	ɡ h o z a l i
ghozi	ɡ h o z i
gigi	ɡ i ɡ i
giliran	ɡ i l i r a n
gimana	ɡ i m a n a
ginseng	ɡ i n s ə ŋ
gintings	ɡ i n t i ŋ s
giro	ɡ i r o
gitar	ɡ i t a r
gitu	ɡ i t u
giuliani	ɡ i u l i a n i
gizi	ɡ i z i
gizinya	ɡ i z i ɲ a
glenn	ɡ l ɛ n n
glenyengan	ɡ l ə ɲ ɛ ŋ a n
global	ɡ l o b a l
globalisasi	ɡ l o b a l i s a s i
glodok	ɡ l o d o k
glonggongan	ɡ l o ŋ ɡ o ŋ a n
glumpang	ɡ l u m p a ŋ
goa	ɡ o a
gocap	ɡ o tʃ a p
goeslaw	ɡ u s l a w
gofar	ɡ o f a r
gogon	ɡ o ɡ o n
gohzali	ɡ o h z a l i
gol	ɡ o l
golf	ɡ o l f
golfnya	ɡ o l f ɲ a
golkar	ɡ o l k a r
golok	ɡ o l o k
gonzales	ɡ o n z a l ə s
gorengnya	ɡ ɔ r ɛ ŋ ɲ a
goro	ɡ ɔ r o
gotong	ɡ o t o ŋ
goyah	ɡ o j a h
goyang	ɡ o j a ŋ
gozali	ɡ o z a l i
grace	ɡ r a tʃ ə
graha	ɡ r a h a
grahadi	ɡ r a h a d i
graham	ɡ r a h a m
granat	ɡ r a n a t
grasi	ɡ r a s i
gratis	ɡ r a t i s
gresik	ɡ r ɛ s i k
grosir	ɡ r o s i r
grup	ɡ r u p
grup-grup	ɡ r u p ɡ r u p
gsm	ɡ e ə s ɛ m
gubernur	ɡ u b ɛ r n u r
gubuk	ɡ u b u k
gudang	ɡ u d a ŋ
gue	ɡ u ə
gufron	ɡ u f r o n
gugatan	ɡ u ɡ a t a n
guna	ɡ u n a
gunakan	ɡ u n a k a n
gunawan	ɡ u n a w a n
gundul	ɡ u n d u l
gunung	ɡ u n u ŋ
gurau	ɡ u r aʊ
guraunya	ɡ u r aʊ ɲ a
guritno	ɡ u r i t n o
guru	ɡ u r u
gus	ɡ u s
gusmao	ɡ u s m a o
gusmardi	ɡ u s m a r d i
guyonan	ɡ u j o n a n
habib	h a b i b
habis	h a b i s
habis-habisan	h a b i s h a b i s a n
hadad	h a d a d
hadapan	h a d a p a n
hadir	h a d i r
hadisunyoto	h a d i s u ɲ o t o
hadiwijoyo	h a d i w i dʒ o j o
hai	h aɪ
haji	h a dʒ i
hak	h a k
hakim	h a k i m
hal	h a l
halaman	h a l a m a n
halamannya	h a l a m a n ɲ a
halte	h a l t ə
halte-halte	h a l t ə h a l t ə
haluan	h a l u a n
halus	h a l u s
ham	h a m
hamad	h a m a d
hambatan	h a m b a t a n
hamid	h a m i d
hamzah	h a m z a h
hanafiah	h a n a f i a h
handoyo	h a n d o j o
hangat	h a ŋ a t
hangus	h a ŋ u s
hantui	h a n t u i
hanya	h a ɲ a
hanyut	h a ɲ u t
harapan	h a r a p a n
harco	h a r tʃ o
harga	h a r ɡ a
harganya	h a r ɡ a ɲ a
hari	h a r i
harian	h a r i a n
harianto	h a r i a n t o
harimau	h a r i m aʊ
harley	h a r l ə j
harmayn	h a r m a j n
harmoni	h a r m o n i
harta	h a r t a
hartini	h a r t i n i
harto	h a r t o
hartono	h a r t o n o
haruku	h a r u k u
harun	h a r u n
harunantyo	h a r u n a n t j o
harus	h a r u s
harvey	h a r v ə j
haryanto	h a r j a n t o
haryono	h a r j o n o
hasan	h a s a n
hasibuan	h a s i b u a n
hasil	h a s i l
hasil-hasil	h a s i l h a s i l
hasjrul	h a ç r u l
hassan	h a s a n
hasto	h a s t o
hasyim	h a ç i m
hati	h a t i
hatta	h a t t a
haus	h aʊ s
hawaii	h a w aɪ i
haz	h a z
hazli	h a z l i
hebat	h ɛ b a t
heboh	h ɛ b o h
hegemoni	h ɛ ɡ ə m o n i
hehamahua	h ɛ h a m a h u a
hei	h ɛ i
hektar	h ɛ k t a r
helai-helai	h ɛ l aɪ h ɛ l aɪ
helikopter	h ɛ l i k o p t ə r
heliped	h ə l i p ə d
helm	h ɛ l m
hendak	h ɛ n d a k
hendaknya	h ə n d a k ɲ a
hendra	h ɛ n d r a
hendrawan	h ə n d r a w a n
hendry	h ɛ n d r j
hengkang	h ɛ ŋ k a ŋ
hengky	h ɛ ŋ k j
hentakan-hentakan	h ə n t a k a n h ə n t a k a n
henti	h ɛ n t i
hentikan	h ə n t i k a n
hepatitis	h ɛ p a t i t i s
heran	h ɛ r a n
heriawan	h ɛ r i a w a n
herlambang	h ə r l a m b a ŋ
herman	h ɛ r m a n
herna	h ɛ r n a
heroin	h ə r o i n
heru	h ɛ r u
herve	h ɛ r v ə
hesti	h ɛ s t i
hetty	h ɛ t t j
hewan	h ɛ w a n
hiba	h i b a
hidayat	h i d a j a t
hidetoshi	h i d ə t o s h i
hidung	h i d u ŋ
hidup	h i d u p
hidup-hidup	h i d u p h i d u p
hidupnya	h i d u p ɲ a
hijau	h i dʒ aʊ
hijaunya	h i dʒ aʊ ɲ a
hijrah	h i dʒ r a h
hilal	h i l a l
hilang	h i l a ŋ
himbau	h i m b aʊ
hindari	h i n d a r i
hingga	h i ŋ ɡ a
hino	h i n o
hirau	h i r aʊ
hiruk-pikuk	h i r u k p i k u k
hisyam	h i ç a m
hitam	h i t a m
hoegeng	h u ɡ ə ŋ
hoesainy	h u s aɪ ɲ
hoiriah	h o i r i a h
homoseksual	h o m o s ə k s u a l
hong	h o ŋ
hongaria	h o ŋ a r i a
hongkong	h o ŋ k o ŋ
honorer	h o n ɔ r ə r
horison	h ɔ r i s o n
horizon	h ɔ r i z o n
hormati	h ɔ r m a t i
hotel	h o t ə l
hotman	h o t m a n
howard	h o w a r d
hubble	h u b b l ə
hubungan	h u b u ŋ a n
huda	h u d a
hudson	h u d s o n
hughes	h u ɡ h ə s
hujan	h u dʒ a n
hukum	h u k u m
hukumnya	h u k u m ɲ a
hulu	h u l u
humas	h u m a s
huruf	h u r u f
hurufnya	h u r u f ɲ a
husein	h u s ɛ i n
husodo	h u s o d o
hutabarat	h u t a b a r a t
hutan	h u t a n
hutapea	h u t a p ɛ a
ia	i a
ialah	i a l a h
ianfu	i a n f u
ibadah	i b a d a h
ibarat	i b a r a t
ibnu	i b n u
ibrahim	i b r a h i m
ibu	i b u
ibunya	i b u ɲ a
ical	i tʃ a l
ichlasul	i χ l a s u l
ichram	i χ r a m
ichwan	i χ w a n
ide	i d ə
ideal	i d ɛ a l
identitas	i d ə n t i t a s
ideologi	i d ə o l o ɡ i
ideologis	i d ə o l o ɡ i s
idris	i d r i s
idrus	i d r u s
idul	i d u l
ifar	i f a r
iguacu	i ɡ u a tʃ u
ihsg	i h s ɡ
ihwal	i h w a l
ihza	i h z a
iis	i i s
ijab	i dʒ a b
ijin	i dʒ i n
ikan	i k a n
ikat	i k a t
ikhdan	i x d a n
ikhlas	i x l a s
ikhsan	i x s a n
ikhtiar	i x t i a r
ikhwanul	i x w a n u l
ikrar	i k r a r
ikut	i k u t
ikuti	i k u t i
ilegal	i l ɛ ɡ a l
ilir	i l i r
illahi	i l a h i
ilmu	i l m u
ilmuwan	i l m u w a n
ilo	i l o
ilyas	i l j a s
imajinasinya	i m a dʒ i n a s i ɲ a
imam	i m a m
iman	i m a n
imannya	i m a n ɲ a
imbalan	i m b a l a n
imbau	i m b aʊ
imbauan	i m b aʊ a n
imbaulah	i m b aʊ l a h
imbaunya	i m b aʊ ɲ a
imbuh	i m b u h
imej	i m ə dʒ
imf	i m f
imigrasi	i m i ɡ r a s i
imperialisme	i m p ə r i a l i s m ə
impian	i m p i a n
implementasi	i m p l ə m ə n t a s i
impor	i m p ɔ r
imran	i m r a n
imron	i m r o n
indah	i n d a h
indar	i n d a r
indekost	i n d ɛ k o s t
indeks	i n d ə k s
india	i n d i a
indo	i n d o
indoexchange	i n d u k s χ a ŋ ə
indofarma	i n d o f a r m a
indolife	i n d o l i f ə
indonesia	i n d o n ə s i a
indorayon	i n d ɔ r a j o n
indra	i n d r a
indrawati	i n d r a w a t i
industri	i n d u s t r i
indvidunya	i n d v i d u ɲ a
inflasi	i n f l a s i
info	i n f o
informasi	i n f ɔ r m a s i
ingat	i ŋ a t
ingatkan	i ŋ a t k a n
inggris	i ŋ ɡ r i s
ingin	i ŋ i n
ini	i n i
inkai	i n k aɪ
insentif	i n s ɛ n t i f
inspektur	i n s p ɛ k t u r
instansi	i n s t a n s i
insyaf	i n ç a f
intan	i n t a n
integritas	i n t ə ɡ r i t a s
intelpam	i n t ɛ l p a m
interaktif	i n t ə r a k t i f
intern	i n t ə r n
internal	i n t ɛ r n a l
internasional	i n t ə r n a s i o n a l
interpelasi	i n t ə r p ə l a s i
interupsi	i n t ə r u p s i
inti	i n t i
intinya	i n t i ɲ a
investasi	i n v ə s t a s i
investor	i n v ɛ s t ɔ r
ipb	i p b
ipda	i p d a
ipnu	i p n u
iptu	i p t u
irak	i r a k
iran	i r a n
irawan	i r a w a n
ireng	i r ə ŋ
irfan	i r f a n
irham	i r h a m
irian	i r i a n
irianto	i r i a n t o
irjen	i r dʒ ə n
irsyadi	i r ç a d i
irwan	i r w a n
isa	i s a
ishak	i s h a k
isi	i s i
isinya	i s i ɲ a
iskandar	i s k a n d a r
islah	i s l a h
islam	i s l a m
islamiyah	i s l a m i j a h
ismail	i s m aɪ l
israel	i s r a ə l
istana	i s t a n a
istigfar	i s t i ɡ f a r
istilah	i s t i l a h
istimewa	i s t i m ɛ w a
istri	i s t r i
istrinya	i s t r i ɲ a
isu	i s u
iswan	i s w a n
isyarat	i ç a r a t
isyaratkan	i ç a r a t k a n
italia	i t a l i a
itjen	i tʃ ə n
itu	i t u
itulah	i t u l a h
iuran	i u r a n
ivan	i v a n
iwan	i w a n
iwantono	i w a n t o n o
iya	i j a
iza	i z a
izin	i z i n
izumi	i z u m i
jabatan	dʒ a b a t a n
jadi	dʒ a d i
jadi-jadian	dʒ a d i dʒ a d i a n
jadwal	dʒ a d w a l
jafar	dʒ a f a r
jaga	dʒ a ɡ a
jagat	dʒ a ɡ a t
jago	dʒ a ɡ o
jaguar	dʒ a ɡ u a r
jagung	dʒ a ɡ u ŋ
jahat	dʒ a h a t
jajaran	dʒ a dʒ a r a n
jakarta	dʒ a k a r t a
jakarta-cirebon	dʒ a k a r t a tʃ i r ɛ b o n
jaksa	dʒ a k s a
jalan	dʒ a l a n
jalan-jalan	dʒ a l a n dʒ a l a n
jalur	dʒ a l u r
jam	dʒ a m
jamaah	dʒ a m a a h
jamal	dʒ a m a l
jambi	dʒ a m b i
jamin	dʒ a m i n
jaminan	dʒ a m i n a n
jamsostek	dʒ a m s o s t ə k
jamur	dʒ a m u r
janda	dʒ a n d a
jangan	dʒ a ŋ a n
jangankan	dʒ a ŋ a n k a n
jangka	dʒ a ŋ k a
jangkauan	dʒ a ŋ k aʊ a n
janji	dʒ a n dʒ i
janjinya	dʒ a n dʒ i ɲ a
jantan	dʒ a n t a n
jantung	dʒ a n t u ŋ
januari	dʒ a n u a r i
jarak	dʒ a r a k
jaringan	dʒ a r i ŋ a n
jarwo	dʒ a r w o
jasa	dʒ a s a
jasmi	dʒ a s m i
jateng	dʒ a t ə ŋ
jati	dʒ a t i
jatim	dʒ a t i m
jatiuwung	dʒ a t i u w u ŋ
jatuh	dʒ a t u h
jauh	dʒ aʊ h
jauh-jauh	dʒ aʊ h dʒ aʊ h
jawa	dʒ a w a
jawab	dʒ a w a b
jawaban	dʒ a w a b a n
jaya	dʒ a j a
jayadi	dʒ a j a d i
jayusman	dʒ a j u s m a n
jazed	dʒ a z ə d
jeblok	dʒ ɛ b l o k
jeda	dʒ ɛ d a
jeddah	dʒ ɛ d d a h
jeffry	dʒ ɛ f r j
jegal	dʒ ɛ ɡ a l
jehalim	dʒ ə h a l i m
jejak	dʒ ɛ dʒ a k
jeje	dʒ ɛ dʒ ə
jelas	dʒ ɛ l a s
jelas-jelas	dʒ ɛ l a s dʒ ɛ l a s
jemaah	dʒ ə m a a h
jembadi	dʒ ə m b a d i
jembatan	dʒ ə m b a t a n
jenasah	dʒ ə n a s a h
jenazah	dʒ ə n a z a h
jendela	dʒ ə n d ɛ l a
jenderal	dʒ ə n d ɛ r a l
jendral	dʒ ɛ n d r a l
jenewa	dʒ ə n ɛ w a
jenggot	dʒ ɛ ŋ ɡ o t
jenguk	dʒ ɛ ŋ u k
jenjang	dʒ ɛ n dʒ a ŋ
jepang	dʒ ɛ p a ŋ
jepara	dʒ ə p a r a
jerman	dʒ ɛ r m a n
jernih	dʒ ɛ r n i h
jerusalem	dʒ ɛ r u s a l ə m
jiang	dʒ i a ŋ
jihad	dʒ i h a d
jihandak	dʒ i h a n d a k
jika	dʒ i k a
jilbab	dʒ i l b a b
jilid	dʒ i l i d
jimly	dʒ i m l j
jip	dʒ i p
jiwa	dʒ i w a
jodoh	dʒ o d o h
joget	dʒ o ɡ ə t
joglo	dʒ o ɡ l o
johar	dʒ o h a r
jojo	dʒ o dʒ o
joko	dʒ o k o
jombang	dʒ o m b a ŋ
jompo	dʒ o m p o
jongos	dʒ o ŋ o s
jonny	dʒ o n ɲ
jordan	dʒ ɔ r d a n
jose	dʒ o s ə
josef	dʒ o s ə f
josis	dʒ o s i s
juanda	dʒ u a n d a
juara	dʒ u a r a
judi	dʒ u d i
judono	dʒ u d o n o
judul	dʒ u d u l
juga	dʒ u ɡ a
jugun	dʒ u ɡ u n
jujur	dʒ u dʒ u r
julia	dʒ u l i a
julukan	dʒ u l u k a n
jumat	dʒ u m a t
jumbo	dʒ u m b o
jumlah	dʒ u m l a h
jumlahnya	dʒ u m l a h ɲ a
jumpa	dʒ u m p a
jun	dʒ u n
junaedi	dʒ u n a ɛ d i
jung-hwan	dʒ u ŋ h w a n
juoro	dʒ u ɔ r o
jurangmangu	dʒ u r a ŋ m a ŋ u
juri	dʒ u r i
juru	dʒ u r u
jurusan	dʒ u r u s a n
justru	dʒ u s t r u
juta	dʒ u t a
juventus	dʒ u v ɛ n t u s
juwono	dʒ u w o n o
kabag	k a b a ɡ
kabar	k a b a r
kabel	k a b ə l
kabila	k a b i l a
kabinet	k a b i n ə t
kabul	k a b u l
kabulog	k a b u l o ɡ
kabupaten	k a b u p a t ə n
kabur	k a b u r
kaca	k a tʃ a
kaca-kaca	k a tʃ a k a tʃ a
kacang	k a tʃ a ŋ
kacanya	k a tʃ a ɲ a
kacau	k a tʃ aʊ
kacaunya	k a tʃ aʊ ɲ a
kacung	k a tʃ u ŋ
kadang	k a d a ŋ
kadar	k a d a r
kader	k a d ə r
kaditserse	k a d i t s ɛ r s ə
kafe	k a f ə
kaget	k a ɡ ə t
kagetkan	k a ɡ ɛ t k a n
kahayan	k a h a j a n
kahfi	k a h f i
kain	k aɪ n
kaitannya	k aɪ t a n ɲ a
kaji	k a dʒ i
kakak	k a k a k
kakao	k a k a o
kaki	k a k i
kala	k a l a
kalangan	k a l a ŋ a n
kalau	k a l aʊ
kalaupun	k a l aʊ p u n
kalbe	k a l b ə
kaleb	k a l ə b
kalem	k a l ə m
kali	k a l i
kalimantan	k a l i m a n t a n
kalla	k a l a
kalsel	k a l s ə l
kalteng	k a l t ə ŋ
kaltim	k a l t i m
kamaruzzaman	k a m a r u z z a m a n
kami	k a m i
kampanye	k a m p a ɲ ə
kampung	k a m p u ŋ
kampus	k a m p u s
kamra	k a m r a
kamu	k a m u
kan	k a n
kanada	k a n a d a
kancil	k a n tʃ i l
kandang	k a n d a ŋ
kandung	k a n d u ŋ
kang	k a ŋ
kans	k a n s
kantor	k a n t ɔ r
kantung	k a n t u ŋ
kanvas	k a n v a s
kaos	k a o s
kapal	k a p a l
kapal-kapal	k a p a l k a p a l
kapan	k a p a n
kapasitas	k a p a s i t a s
kapau	k a p aʊ
kapolda	k a p o l d a
kapolres	k a p o l r ə s
kapolri	k a p o l r i
kapolwil	k a p o l w i l
kapolwiltabes	k a p o l w i l t a b ə s
kapten	k a p t ə n
kapuskodalops	k a p u s k o d a l o p s
kapuspen	k a p u s p ə n
karate	k a r a t ə
karena	k a r ɛ n a
karet	k a r ə t
karim	k a r i m
karno	k a r n o
kartu	k a r t u
karya	k a r j a
karyawan	k a r j a w a n
kas	k a s
kasasi	k a s a s i
kaset	k a s ə t
kasiepo	k a s i p o
kasih	k a s i h
kasihan	k a s i h a n
kasman	k a s m a n
kasogi	k a s o ɡ i
kassospol	k a s o s p o l
kasus	k a s u s
kasus-kasus	k a s u s k a s u s
kata	k a t a
katanya	k a t a ɲ a
katedral	k a t ɛ d r a l
kategori	k a t ə ɡ ɔ r i
katolik	k a t o l i k
kau	k aʊ
kaum	k aʊ m
kaus	k aʊ s
kawan	k a w a n
kawasan	k a w a s a n
kawat	k a w a t
kawula	k a w u l a
kaya	k a j a
kayak	k a j a k
kayaknya	k a j a k ɲ a
kayu	k a j u
ke	k ə
keadaan	k ə a d a a n
keagungan	k ə a ɡ u ŋ a n
keamanan	k ə a m a n a n
keambrukan	k ə a m b r u k a n
kebebasan	k ə b ə b a s a n
keberadaan	k ə b ɛ r a d a a n
keberatan	k ə b ə r a t a n
keberhasilannya	k ə b ɛ r h a s i l a n ɲ a
keberpihakan	k ə b ɛ r p i h a k a n
kebetulan	k ə b ə t u l a n
kebijakan	k ə b i dʒ a k a n
kebon	k ɛ b o n
kebutuhan	k ə b u t u h a n
kecamatan	k ə tʃ a m a t a n
kecap	k ɛ tʃ a p
kecelakaan	k ə tʃ ɛ l a k a a n
kecenderungan	k ə tʃ ɛ n d ə r u ŋ a n
kecewa	k ə tʃ ɛ w a
kecil	k ɛ tʃ i l
kecil-kecilan	k ɛ tʃ i l k ə tʃ i l a n
kecolongan	k ə tʃ o l o ŋ a n
kecuali	k ə tʃ u a l i
kedai	k ɛ d aɪ
kedatangan	k ə d a t a ŋ a n
kediaman	k ə d i a m a n
kediri	k ə d i r i
kedokteran	k ə d o k t ɛ r a n
kedua	k ə d u a
keduanya	k ə d u a ɲ a
kedubes	k ə d u b ə s
kedudukan	k ə d u d u k a n
kedutaan	k ə d u t a a n
kehendak	k ə h ɛ n d a k
kehidupan	k ə h i d u p a n
kehilangan	k ə h i l a ŋ a n
kehutanan	k ə h u t a n a n
kejagung	k ə dʒ a ɡ u ŋ
kejaksaan	k ə dʒ a k s a a n
kejora	k ə dʒ ɔ r a
kekagumannya	k ə k a ɡ u m a n ɲ a
kekalahan	k ə k a l a h a n
kekerasan	k ə k ə r a s a n
kekhawatiran	k ə x a w a t i r a n
kekhilafan	k ə x i l a f a n
kekuasaan	k ə k u a s a a n
kekuatan	k ə k u a t a n
kekurangan	k ə k u r a ŋ a n
kelanjutan	k ə l a n dʒ u t a n
kelapa	k ə l a p a
kelas	k ɛ l a s
kelebihan	k ə l ə b i h a n
kelelawar	k ə l ə l a w a r
kelengkapan	k ə l ə ŋ k a p a n
kelewang	k ə l ɛ w a ŋ
kelihatan	k ə l i h a t a n
kelompok	k ə l o m p o k
kelompok-kelompok	k ə l o m p o k k ə l o m p o k
kelompoknya	k ə l o m p o k ɲ a
kelor	k ɛ l ɔ r
keluar	k ə l u a r
keluarga	k ə l u a r ɡ a
keluh	k ɛ l u h
kelurahan	k ə l u r a h a n
kemal	k ɛ m a l
kemana	k ə m a n a
kemarin	k ə m a r i n
kembali	k ə m b a l i
kemenangan	k ə m ə n a ŋ a n
kemerdekaan	k ə m ɛ r d ə k a a n
kemudian	k ə m u d i a n
kemungkinan	k ə m u ŋ k i n a n
kenaikan	k ə n aɪ k a n
kenapa	k ə n a p a
kencang	k ə n tʃ a ŋ
kendaraan	k ə n d a r a a n
kendati	k ə n d a t i
kendor	k ə n d ɔ r
kenegaraan	k ə n ɛ ɡ a r a a n
kepada	k ə p a d a
kepala	k ə p a l a
kepalanya	k ə p a l a ɲ a
kepemimpinan	k ə p ɛ m i m p i n a n
kepentingan	k ə p ə n t i ŋ a n
kepepet	k ə p ɛ p ə t
kepercayaan	k ə p ɛ r tʃ a j a a n
keperluan	k ə p ə r l u a n
kepmenaker	k ə p m ə n a k ə r
keponakannya	k ə p o n a k a n ɲ a
keppres	k ɛ p r ə s
kepresidenan	k ə p r ɛ s i d ɛ n a n
kepulangan	k ə p u l a ŋ a n
kepulauan	k ə p u l aʊ a n
keputusan	k ə p u t u s a n
keputusasaan	k ə p u t u s a s a a n
kerajaan	k ə r a dʒ a a n
kerangka	k ə r a ŋ k a
kerap	k ɛ r a p
keras	k ɛ r a s
kerbau	k ɛ r b aʊ
kerentanan	k ə r ə n t a n a n
kereta	k ə r ɛ t a
kering	k ɛ r i ŋ
kerja	k ɛ r dʒ a
keruan	k ə r u a n
kerudung	k ə r u d u ŋ
kerugian	k ə r u ɡ i a n
kerusakan	k ə r u s a k a n
kerusuhan	k ə r u s u h a n
kesaksian	k ə s a k s i a n
kesal	k ɛ s a l
kesalahan	k ə s a l a h a n
kesamaan	k ə s a m a a n
kesan	k ɛ s a n
kesehatan	k ə s ə h a t a n
kesel	k ɛ s ə l
kesempatan	k ə s ə m p a t a n
kesenian	k ə s ə n i a n
kesepakatan	k ə s ɛ p a k a t a n
keset	k ɛ s ə t
kesibukan	k ə s i b u k a n
kesowo	k ə s o w o
kesra	k ɛ s r a
kesulitan	k ə s u l i t a n
ketahuan	k ə t a h u a n
ketakutan	k ə t a k u t a n
ketangkep	k ə t a ŋ k ə p
ketapang-gilimanuk	k ə t a p a ŋ ɡ i l i m a n u k
ketat	k ɛ t a t
keterangan	k ə t ə r a ŋ a n
ketetapan	k ə t ə t a p a n
ketidakpastian	k ə t i d a k p a s t i a n
ketidaksempurnaan	k ə t i d a k s ɛ m p u r n a a n
ketiga	k ə t i ɡ a
ketiganya	k ə t i ɡ a ɲ a
ketika	k ə t i k a
ketimbang	k ə t i m b a ŋ
ketok	k ɛ t o k
ketua	k ə t u a
keturunan	k ə t u r u n a n
keuangan	k ə u a ŋ a n
keuntungan	k ə u n t u ŋ a n
kewell	k ɛ w ə l
kewenangan	k ə w ə n a ŋ a n
khadijah	x a d i dʒ a h
khairuddin	x aɪ r u d d i n
khalayak	x a l a j a k
khalil	x a l i l
kharisma	x a r i s m a
khas	x a s
khawatir	x a w a t i r
khawatirkan	x a w a t i r k a n
khayal	x a j a l
khazanah	x a z a n a h
khidmat	x i d m a t
khilaf	x i l a f
khirom	x i r o m
khitanan	x i t a n a n
khofifah	x o f i f a h
khoirul	x o i r u l
kholid	x o l i d
kholifah	x o l i f a h
kholik	x o l i k
kholis	x o l i s
khotbahnya	x o t b a h ɲ a
khotib	x o t i b
khrisna	x r i s n a
khusus	x u s u s
khususnya	x u s u s ɲ a
khusyuk	x u ç u k
khutbah	x u t b a h
ki	k i
kiai	k i aɪ
kian	k i a n
kiat	k i a t
kicau	k i tʃ aʊ
kiemas	k i m a s
kilah	k i l a h
kilas	k i l a s
kilauan	k i l aʊ a n
kimia	k i m i a
kimpraswil	k i m p r a s w i l
kinerja	k i n ɛ r dʒ a
kini	k i n i
kios	k i o s
kira	k i r a
kiri	k i r i
kita	k i t a
kitab	k i t a b
klaim	k l aɪ m
klaimnya	k l aɪ m ɲ a
klarifikasi	k l a r i f i k a s i
klasemen	k l a s ɛ m ə n
klasik	k l a s i k
klien	k l i n
klinik	k l i n i k
kliring	k l i r i ŋ
kloter	k l o t ə r
klub	k l u b
klub-klub	k l u b k l u b
klubnya	k l u b ɲ a
knalpot	k n a l p o t
koboi	k o b o i
kocok	k o tʃ o k
kode	k o d ə
kodim	k o d i m
kodya	k o d j a
koes	k u s
koizumi	k o i z u m i
kok	k o k
koko	k o k o
kolakops	k o l a k o p s
koleksi	k o l ɛ k s i
kolektif	k o l ɛ k t i f
kolom	k o l o m
kolonel	k o l o n ə l
kolusi	k o l u s i
komandan	k o m a n d a n
komando	k o m a n d o
komat-kamit	k o m a t k a m i t
komentar	k o m ɛ n t a r
komisaris	k o m i s a r i s
komisi	k o m i s i
komite	k o m i t ə
komitmen	k o m i t m ə n
komitmennya	k o m i t m ɛ n ɲ a
komjen	k o m dʒ ə n
kompas	k o m p a s
kompi	k o m p i
komplain	k o m p l aɪ n
komplek	k o m p l ə k
kompleks	k o m p l ə k s
kompyang	k o m p j a ŋ
komunikasi	k o m u n i k a s i
komunis	k o m u n i s
kondisi	k o n d i s i
kondisinya	k o n d i s i ɲ a
konduitenya	k o n d u i t ɛ ɲ a
konferensi	k o n f ə r ɛ n s i
konflik	k o n f l i k
konflik-konflik	k o n f l i k k o n f l i k
konfrontatif	k o n f r o n t a t i f
konghucu	k o ŋ h u tʃ u
kongkow-kongkow	k o ŋ k o w k o ŋ k o w
kongo	k o ŋ o
konprehensif	k o n p r ə h ɛ n s i f
konsekuensi	k o n s ə k u ɛ n s i
konsekwensinya	k o n s ə k w ə n s i ɲ a
konsensus	k o n s ɛ n s u s
konsentrasi	k o n s ə n t r a s i
konsep	k o n s ə p
konsepnya	k o n s ɛ p ɲ a
konservasi	k o n s ə r v a s i
konsisten	k o n s i s t ə n
konsolidasi	k o n s o l i d a s i
konsul	k o n s u l
konsumen	k o n s u m ə n
konsumsi	k o n s u m s i
kontainernya	k o n t aɪ n ɛ r ɲ a
konteks	k o n t ə k s
konteksnya	k o n t ɛ k s ɲ a
kontinyu	k o n t i ɲ u
kontrak	k o n t r a k
kontraktor	k o n t r a k t ɔ r
kontrol	k o n t r o l
konvoi	k o n v o i
konyol	k o ɲ o l
koordinasi	k o ɔ r d i n a s i
koordinator	k o ɔ r d i n a t ɔ r
koperasi	k o p ə r a s i
kopi	k o p i
kopral	k o p r a l
koran	k ɔ r a n
korban	k ɔ r b a n
korea	k ɔ r ɛ a
korem	k ɔ r ə m
korps	k ɔ r p s
korsel	k ɔ r s ə l
korupsi	k ɔ r u p s i
kosasih	k o s a s i h
kosgoro	k o s ɡ ɔ r o
kosong	k o s o ŋ
kostrad	k o s t r a d
kota	k o t a
kotamadya	k o t a m a d j a
kotor	k o t ɔ r
krayan	k r a j a n
kredit	k r ɛ d i t
kriminolog	k r i m i n o l o ɡ
krisis	k r i s i s
kristen	k r i s t ə n
kristus	k r i s t u s
kritikan	k r i t i k a n
kritikus	k r i t i k u s
kritis	k r i t i s
kroasia	k r o a s i a
kronik	k r o n i k
kronjo	k r o n dʒ o
krueng	k r u ə ŋ
kuala	k u a l a
kuasa	k u a s a
kuat	k u a t
kubu	k u b u
kuda	k u d a
kue	k u ə
kuenya	k u ɛ ɲ a
kujang	k u dʒ a ŋ
kuliah	k u l i a h
kulit	k u l i t
kultur	k u l t u r
kunci	k u n tʃ i
kuncoroyakti	k u n tʃ ɔ r o j a k t i
kuning	k u n i ŋ
kunjungan	k u n dʒ u ŋ a n
kunjungannya	k u n dʒ u ŋ a n ɲ a
kuno	k u n o
kupang	k u p a ŋ
kuping	k u p i ŋ
kurang	k u r a ŋ
kurir	k u r i r
kurs	k u r s
kursi	k u r s i
kurtubi	k u r t u b i
kurus	k u r u s
kusbini	k u s b i n i
kusnadi	k u s n a d i
kusnanto	k u s n a n t o
kutip	k u t i p
kutuk	k u t u k
kuwait	k u w aɪ t
kwaci	k w a tʃ i
kwik	k w i k
kwintal	k w i n t a l
kyai	k j aɪ
kyoto	k j o t o
la	l a
laba	l a b a
labfor	l a b f ɔ r
labil	l a b i l
lacak	l a tʃ a k
ladeni	l a d ɛ n i
lagi	l a ɡ i
lagu	l a ɡ u
lagu-lagu	l a ɡ u l a ɡ u
lahir	l a h i r
lain	l aɪ n
lain-lainnya	l aɪ n l aɪ n ɲ a
lainnya	l aɪ n ɲ a
laju	l a dʒ u
lakon	l a k o n
laksamana	l a k s a m a n a
lakukan	l a k u k a n
lalu	l a l u
lama	l a m a
lamban	l a m b a n
lambang	l a m b a ŋ
lampau	l a m p aʊ
lampu	l a m p u
landai-landai	l a n d aɪ l a n d aɪ
langkah	l a ŋ k a h
langkah-langkah	l a ŋ k a h l a ŋ k a h
langsung	l a ŋ s u ŋ
lanjut	l a n dʒ u t
lantai	l a n t aɪ
lantik	l a n t i k
lapangan	l a p a ŋ a n
lapor	l a p ɔ r
laptop	l a p t o p
lari	l a r i
laris	l a r i s
laskar	l a s k a r
laut	l aʊ t
lava	l a v a
lawan	l a w a n
lawu	l a w u
lazim	l a z i m
lebaksiu	l ɛ b a k s i u
lebanon	l ə b a n o n
lebatnya	l ə b a t ɲ a
lebdorini	l ɛ b d ɔ r i n i
lebih	l ɛ b i h
ledakan	l ə d a k a n
legal	l ɛ ɡ a l
legenda	l ə ɡ ɛ n d a
legislatif	l ɛ ɡ i s l a t i f
legowo	l ə ɡ o w o
leihitu	l ɛ i h i t u
lelaki	l ə l a k i
lele	l ɛ l ə
lembaga	l ə m b a ɡ a
lemhanas	l ə m h a n a s
lempar	l ɛ m p a r
lempeng	l ɛ m p ə ŋ
lengang	l ɛ ŋ a ŋ
lengkap	l ɛ ŋ k a p
lengkong	l ɛ ŋ k o ŋ
leo	l ɛ o
leptospirosis	l ɛ p t o s p i r o s i s
lereng	l ɛ r ə ŋ
lestari	l ə s t a r i
letak	l ɛ t a k
letjen	l ɛ tʃ ə n
letkol	l ɛ t k o l
level	l ɛ v ə l
levy	l ɛ v j
lewat	l ɛ w a t
lha	l h a
lho	l h o
liar	l i a r
libatkan	l i b a t k a n
liberal	l i b ɛ r a l
libero	l i b ɛ r o
liem	l i m
lihai	l i h aɪ
lihatnya	l i h a t ɲ a
likuid	l i k u i d
likuiditas	l i k u i d i t a s
lima	l i m a
lindung	l i n d u ŋ
lingkungan	l i ŋ k u ŋ a n
lintas	l i n t a s
lipat	l i p a t
lippo	l i p o
lipstik	l i p s t i k
lirik	l i r i k
lisa	l i s a
listrik	l i s t r i k
listyo	l i s t j o
lita	l i t a
liwa	l i w a
liza	l i z a
lobi	l o b i
logat	l o ɡ a t
logistik	l o ɡ i s t i k
lokal	l o k a l
lokasi	l o k a s i
lokasinya	l o k a s i ɲ a
loket	l o k ə t
lokomotif	l o k o m o t i f
lolos	l o l o s
lonceng	l o n tʃ ə ŋ
london	l o n d o n
longsor	l o ŋ s ɔ r
longsornya	l o ŋ s ɔ r ɲ a
loro	l ɔ r o
lorosae	l ɔ r o s a ə
luar	l u a r
luas	l u a s
lubulinggau	l u b u l i ŋ ɡ aʊ
lucu	l u tʃ u
ludes	l u d ə s
luka	l u k a
lukanya	l u k a ɲ a
lulusan	l u l u s a n
lumbun	l u m b u n
lumpur	l u m p u r
lunak	l u n a k
lunglai	l u ŋ l aɪ
lutfi	l u t f i
luthfi	l u t h f i
luwes	l u w ə s
ma	m a
maaf	m a a f
mabanta	m a b a n t a
mabes	m a b ə s
macam	m a tʃ a m
macet	m a tʃ ə t
macetnya	m a tʃ ɛ t ɲ a
machfudz	m a χ f u d z
machmud	m a χ m u d
madjid	m a dʒ i d
madrasah	m a d r a s a h
maftuhin	m a f t u h i n
magdalena	m a ɡ d a l ɛ n a
magnus	m a ɡ n u s
mahal	m a h a l
mahasiswa	m a h a s i s w a
mahfud	m a h f u d
mahligai	m a h l i ɡ aɪ
maja	m a dʒ a
majalah	m a dʒ a l a h
majelis	m a dʒ ɛ l i s
maju	m a dʒ u
maka	m a k a
makam	m a k a m
makanan	m a k a n a n
makannya	m a k a n ɲ a
makanya	m a k a ɲ a
makarim	m a k a r i m
makhluk	m a x l u k
makin	m a k i n
makna	m a k n a
makruf	m a k r u f
maksud	m a k s u d
maktab	m a k t a b
mal	m a l
malah	m a l a h
malaihollo	m a l aɪ h o l o
malaikat	m a l aɪ k a t
malam	m a l a m
malas	m a l a s
malaysia	m a l a j s i a
malu	m a l u
maluku	m a l u k u
mama	m a m a
mami	m a m i
mampang	m a m p a ŋ
mampu	m a m p u
mana	m a n a
manaf	m a n a f
mandarin	m a n d a r i n
mandat	m a n d a t
mandau	m a n d aʊ
mandeg	m a n d ə ɡ
mandi	m a n d i
mandiri	m a n d i r i
mandumai	m a n d u m aɪ
mang	m a ŋ
manggabarani	m a ŋ ɡ a b a r a n i
mangun	m a ŋ u n
manis	m a n i s
mansyur	m a n ç u r
mantan	m a n t a n
manteb	m a n t ə b
manuel	m a n u ə l
manurung	m a n u r u ŋ
manusia	m a n u s i a
mapindo	m a p i n d o
mapolres	m a p o l r ə s
maret	m a r ə t
marga	m a r ɡ a
maridjan	m a r i dʒ a n
marina	m a r i n a
marinir	m a r i n i r
mario	m a r i o
marley	m a r l ə j
maroso	m a r o s o
marten	m a r t ə n
martin	m a r t i n
marwah	m a r w a h
marzuki	m a r z u k i
mas	m a s
masa	m a s a
masak	m a s a k
masakan	m a s a k a n
masalah	m a s a l a h
masalah-masalah	m a s a l a h m a s a l a h
masalahnya	m a s a l a h ɲ a
mashudi	m a s h u d i
mashuri	m a s h u r i
masih	m a s i h
masing-masing	m a s i ŋ m a s i ŋ
masio	m a s i o
masjid	m a ç i d
massa	m a s a
massal	m a s a l
masuk	m a s u k
masuki	m a s u k i
masuknya	m a s u k ɲ a
masyarakat	m a ç a r a k a t
masyita	m a ç i t a
masyudi	m a ç u d i
masyumi	m a ç u m i
mata	m a t a
matanya	m a t a ɲ a
materai	m a t ɛ r aɪ
materi	m a t ɛ r i
materiil	m a t ə r i i l
mathias	m a t h i a s
mati	m a t i
mati-matian	m a t i m a t i a n
matori	m a t ɔ r i
maturasi	m a t u r a s i
mau	m aʊ
maulid	m aʊ l i d
maunya	m aʊ ɲ a
maupun	m aʊ p u n
maya	m a j a
mayat-mayat	m a j a t m a j a t
mayjen	m a j dʒ ə n
mayjend	m a j dʒ ə n d
mayor	m a j ɔ r
mayoritas	m a j ɔ r i t a s
mbah	m b a h
mbak	m b a k
mbalelo	m b a l ɛ l o
medan	m ɛ d a n
media	m ə d i a
mega	m ɛ ɡ a
megawati	m ə ɡ a w a t i
mei	m ɛ i
meier	m ɛ i r
meine	m ə i n ə
mekanis	m ə k a n i s
mekanisme	m ə k a n i s m ə
mekkah	m ɛ k k a h
melakukan	m ə l a k u k a n
melalui	m ə l a l u i
melambai	m ə l a m b aɪ
melambai-lambaikan	m ə l a m b aɪ l a m b aɪ k a n
melampaui	m ə l a m p aʊ i
melanda	m ə l a n d a
melanggar	m ə l a ŋ ɡ a r
melangkah	m ə l a ŋ k a h
melanjutkan	m ə l a n dʒ u t k a n
melarangnya	m ə l a r a ŋ ɲ a
melarikan	m ə l a r i k a n
melawai	m ə l a w aɪ
melayani	m ə l a j a n i
meledak	m ə l ɛ d a k
melejit	m ə l ɛ dʒ i t
melekat	m ə l ɛ k a t
melemahnya	m ə l ə m a h ɲ a
melempar	m ə l ɛ m p a r
melenceng	m ə l ɛ n tʃ ə ŋ
melepaskan	m ə l ə p a s k a n
melewati	m ə l ə w a t i
melibatkan	m ə l i b a t k a n
melihat	m ə l i h a t
melikuidasi	m ə l i k u i d a s i
melindungi	m ə l i n d u ŋ i
melirik	m ə l i r i k
melly	m ɛ l j
melonjaknya	m ə l o n dʒ a k ɲ a
melontarkannya	m ə l o n t a r k a n ɲ a
meluap	m ə l u a p
melukai	m ə l u k aɪ
melupakan	m ə l u p a k a n
memacetkan	m ə m a tʃ ɛ t k a n
memajukan	m ə m a dʒ u k a n
memakai	m ə m a k aɪ
memanaskan	m ə m a n a s k a n
memandang	m ə m a n d a ŋ
memandikan	m ə m a n d i k a n
memanfaatkan	m ə m a n f a a t k a n
memang	m ɛ m a ŋ
memanggil	m ə m a ŋ ɡ i l
memangnya	m ə m a ŋ ɲ a
memar-memar	m ɛ m a r m ɛ m a r
memastikan	m ə m a s t i k a n
memasuki	m ə m a s u k i
memasukkan	m ə m a s u k k a n
mematahkan	m ə m a t a h k a n
membahayakan	m ə m b a h a j a k a n
membaiknya	m ə m b aɪ k ɲ a
membangun	m ə m b a ŋ u n
membanjirnya	m ə m b a n dʒ i r ɲ a
membantah	m ə m b a n t a h
membantai	m ə m b a n t aɪ
membantu	m ə m b a n t u
membawa	m ə m b a w a
membawahkan	m ə m b a w a h k a n
membawakan	m ə m b a w a k a n
membayar	m ə m b a j a r
membeli	m ə m b ɛ l i
membelot	m ə m b ɛ l o t
membentuk	m ə m b ə n t u k
memberi	m ə m b ɛ r i
memberikan	m ə m b ə r i k a n
memberlakukan	m ə m b ɛ r l a k u k a n
membersihkan	m ə m b ə r s i h k a n
membezuk	m ə m b ɛ z u k
membidangi	m ə m b i d a ŋ i
membidik	m ə m b i d i k
membingungkan	m ə m b i ŋ u ŋ k a n
memboikot	m ə m b o i k o t
membuang	m ə m b u a ŋ
membuat	m ə m b u a t
membubarkan	m ə m b u b a r k a n
membuka	m ə m b u k a
membuktikan	m ə m b u k t i k a n
membutuhkan	m ə m b u t u h k a n
memecahkan	m ə m ə tʃ a h k a n
memenangi	m ə m ə n a ŋ i
memenej	m ə m ɛ n ə dʒ
memenuhi	m ə m ə n u h i
memeriksa	m ə m ə r i k s a
memerintahkan	m ə m ɛ r i n t a h k a n
memerlukan	m ə m ə r l u k a n
memfokuskan	m ə m f o k u s k a n
memicu	m ə m i tʃ u
memikirkan	m ə m i k i r k a n
memiliki	m ə m i l i k i
memimpin	m ə m i m p i n
meminta	m ə m i n t a
memintanya	m ə m i n t a ɲ a
memo	m ɛ m o
memohon	m ə m o h o n
mempengaruhi	m ə m p ə ŋ a r u h i
memperhatikan	m ə m p ə r h a t i k a n
memperhitungkan	m ə m p ə r h i t u ŋ k a n
memperinci	m ə m p ə r i n tʃ i
memperlambat	m ə m p ə r l a m b a t
memperluas	m ə m p ə r l u a s
memperoleh	m ə m p ə r o l ə h
memperpanjang	m ə m p ə r p a n dʒ a ŋ
mempertahankan	m ə m p ə r t a h a n k a n
mempertanggungjawabkan	m ə m p ə r t a ŋ ɡ u ŋ dʒ a w a b k a n
memprotes	m ə m p r o t ə s
mempublikasikan	m ə m p u b l i k a s i k a n
mempunyai	m ə m p u ɲ aɪ
memuat	m ə m u a t
memulai	m ə m u l aɪ
memunculkannya	m ə m u n tʃ u l k a n ɲ a
memungkiri	m ə m u ŋ k i r i
memutus	m ə m u t u s
memutuskan	m ə m u t u s k a n
menag	m ɛ n a ɡ
menahu	m ə n a h u
menaiki	m ə n aɪ k i
menakut-nakuti	m ə n a k u t n a k u t i
menakutkan	m ə n a k u t k a n
menambah	m ə n a m b a h
menambahkan	m ə n a m b a h k a n
menampilkan	m ə n a m p i l k a n
menang	m ɛ n a ŋ
menanggapi	m ə n a ŋ ɡ a p i
menanggapinya	m ə n a ŋ ɡ a p i ɲ a
menanggung	m ə n a ŋ ɡ u ŋ
menangkap	m ə n a ŋ k a p
menanyakan	m ə n a ɲ a k a n
menasihati	m ə n a s i h a t i
mencabut	m ə n tʃ a b u t
mencapai	m ə n tʃ a p aɪ
mencegah	m ə n tʃ ɛ ɡ a h
mencekam	m ə n tʃ ɛ k a m
mencemarkan	m ə n tʃ ə m a r k a n
mencemaskan	m ə n tʃ ə m a s k a n
mencerca	m ə n tʃ ɛ r tʃ a
mencerminkan	m ə n tʃ ə r m i n k a n
menciptakan	m ə n tʃ i p t a k a n
mencla-mencle	m ɛ n tʃ l a m ɛ n tʃ l ə
mencoba	m ə n tʃ o b a
mencontohkan	m ə n tʃ o n t o h k a n
mencret	m ɛ n tʃ r ə t
mencuci	m ə n tʃ u tʃ i
mencukur	m ə n tʃ u k u r
mendadak	m ə n d a d a k
mendarat	m ə n d a r a t
mendasar	m ə n d a s a r
mendatang	m ə n d a t a ŋ
mendatangi	m ə n d a t a ŋ i
mendatangkan	m ə n d a t a ŋ k a n
mendefinisikan	m ə n d ɛ f i n i s i k a n
mendengar	m ə n d ɛ ŋ a r
mendengarkan	m ə n d ə ŋ a r k a n
mendesak	m ə n d ɛ s a k
mendikbud	m ə n d i k b u d
mendiknas	m ə n d i k n a s
mendobrak	m ə n d o b r a k
mendukung	m ə n d u k u ŋ
menebang	m ə n ɛ b a ŋ
meneg	m ɛ n ə ɡ
menegaskan	m ə n ə ɡ a s k a n
menejemen	m ə n ə dʒ ɛ m ə n
menejer	m ə n ɛ dʒ ə r
menekankan	m ə n ə k a n k a n
menelepon	m ə n ə l ɛ p o n
menelusuri	m ə n ɛ l u s u r i
menembaknya	m ə n ə m b a k ɲ a
menembus	m ə n ɛ m b u s
menempati	m ə n ə m p a t i
menemui	m ə n ə m u i
menemukan	m ə n ə m u k a n
menengarai	m ə n ə ŋ a r aɪ
menengok	m ə n ɛ ŋ o k
menentang	m ə n ɛ n t a ŋ
menenteng-nenteng	m ə n ɛ n t ə ŋ n ɛ n t ə ŋ
menentu	m ə n ɛ n t u
menentukan	m ə n ə n t u k a n
menepis	m ə n ɛ p i s
menerangkan	m ə n ə r a ŋ k a n
menerapkan	m ə n ə r a p k a n
menerima	m ə n ə r i m a
menerimanya	m ə n ɛ r i m a ɲ a
mengacaukan	m ə ŋ a tʃ aʊ k a n
mengacungkan	m ə ŋ a tʃ u ŋ k a n
mengada-ada	m ə ŋ a d a a d a
mengadakan	m ə ŋ a d a k a n
mengadu	m ə ŋ a d u
mengajaknya	m ə ŋ a dʒ a k ɲ a
mengajukan	m ə ŋ a dʒ u k a n
mengakibatkan	m ə ŋ a k i b a t k a n
mengaku	m ə ŋ a k u
mengakui	m ə ŋ a k u i
mengalami	m ə ŋ a l a m i
mengalihkan	m ə ŋ a l i h k a n
mengalir	m ə ŋ a l i r
mengamankan	m ə ŋ a m a n k a n
mengambil	m ə ŋ a m b i l
mengancam	m ə ŋ a n tʃ a m
menganggap	m ə ŋ a ŋ ɡ a p
mengangkat	m ə ŋ a ŋ k a t
mengangkut	m ə ŋ a ŋ k u t
mengantar	m ə ŋ a n t a r
mengapa	m ə ŋ a p a
mengasyikkan	m ə ŋ a ç i k k a n
mengatakan	m ə ŋ a t a k a n
mengawal	m ə ŋ a w a l
mengawini	m ə ŋ a w i n i
mengecam	m ə ŋ ɛ tʃ a m
mengecoh	m ə ŋ ɛ tʃ o h
mengedarkan	m ə ŋ ə d a r k a n
mengefektifkan	m ə ŋ ɛ f ə k t i f k a n
mengegolkan	m ə ŋ ə ɡ o l k a n
mengejar	m ə ŋ ɛ dʒ a r
mengelak	m ə ŋ ɛ l a k
mengeluarkan	m ə ŋ ɛ l u a r k a n
mengembangkan	m ə ŋ ə m b a ŋ k a n
mengemukakan	m ə ŋ ɛ m u k a k a n
mengenai	m ə ŋ ɛ n aɪ
mengenal	m ə ŋ ɛ n a l
mengenang	m ə ŋ ɛ n a ŋ
mengencangkan	m ə ŋ ə n tʃ a ŋ k a n
mengendarai	m ə ŋ ə n d a r aɪ
mengerahkan	m ə ŋ ə r a h k a n
mengerem	m ə ŋ ɛ r ə m
mengernyitkan	m ə ŋ ə r ɲ i t k a n
mengerti	m ə ŋ ɛ r t i
mengesahkan	m ə ŋ ə s a h k a n
mengetahui	m ə ŋ ɛ t a h u i
mengganggu	m ə ŋ ɡ a ŋ ɡ u
menggarap	m ə ŋ ɡ a r a p
menggelar	m ə ŋ ɡ ɛ l a r
menggendong	m ə ŋ ɡ ɛ n d o ŋ
menggerebek	m ə ŋ ɡ ə r ɛ b ə k
menggubris	m ə ŋ ɡ u b r i s
menggugat	m ə ŋ ɡ u ɡ a t
menggunakan	m ə ŋ ɡ u n a k a n
menggusur	m ə ŋ ɡ u s u r
menghabisi	m ə ŋ h a b i s i
menghabiskan	m ə ŋ h a b i s k a n
menghadapi	m ə ŋ h a d a p i
menghadiri	m ə ŋ h a d i r i
mengharapkan	m ə ŋ h a r a p k a n
menghardik	m ə ŋ h a r d i k
menghiasi	m ə ŋ h i a s i
menghilang	m ə ŋ h i l a ŋ
menghindari	m ə ŋ h i n d a r i
menghiraukan	m ə ŋ h i r aʊ k a n
menghubungi	m ə ŋ h u b u ŋ i
menghubunginya	m ə ŋ h u b u ŋ i ɲ a
menghunus	m ə ŋ h u n u s
mengibarkan	m ə ŋ i b a r k a n
mengidap	m ə ŋ i d a p
mengigatkan	m ə ŋ i ɡ a t k a n
mengikuti	m ə ŋ i k u t i
mengimbangi	m ə ŋ i m b a ŋ i
mengimbau	m ə ŋ i m b aʊ
menginformasikan	m ə ŋ i n f ɔ r m a s i k a n
mengingatkan	m ə ŋ i ŋ a t k a n
mengintai	m ə ŋ i n t aɪ
mengintervensinya	m ə ŋ i n t ə r v ə n s i ɲ a
mengipas-ngipasi	m ə ŋ i p a s ŋ i p a s i
mengirimkan	m ə ŋ i r i m k a n
mengisyaratkan	m ə ŋ i ç a r a t k a n
mengiyakan	m ə ŋ i j a k a n
mengizinkan	m ə ŋ i z i n k a n
mengklaim	m ɛ ŋ k l aɪ m
mengklarifikasi	m ə ŋ k l a r i f i k a s i
mengkritik	m ə ŋ k r i t i k
mengoceh	m ə ŋ o tʃ ə h
mengontrolnya	m ə ŋ o n t r o l ɲ a
mengorek	m ə ŋ ɔ r ə k
mengorek-ngorek	m ə ŋ ɔ r ə k ŋ ɔ r ə k
mengoyak	m ə ŋ o j a k
mengritik	m ə ŋ r i t i k
menguasai	m ə ŋ u a s aɪ
menguat	m ə ŋ u a t
mengubah	m ə ŋ u b a h
mengubek-ngubek	m ə ŋ u b ə k ŋ u b ə k
mengucap	m ə ŋ u tʃ a p
mengucek-ucek	m ə ŋ u tʃ ə k u tʃ ə k
mengulangi	m ə ŋ u l a ŋ i
mengumumkan	m ə ŋ u m u m k a n
mengungkapkan	m ə ŋ u ŋ k a p k a n
mengungsi	m ə ŋ u ŋ s i
menguntungkan	m ə ŋ u n t u ŋ k a n
mengupayakan	m ə ŋ u p a j a k a n
mengurangi	m ə ŋ u r a ŋ i
mengutarakan	m ə ŋ u t a r a k a n
mengutip	m ə ŋ u t i p
menikahi	m ə n i k a h i
menilai	m ə n i l aɪ
menimbang	m ə n i m b a ŋ
menimbulkan	m ə n i m b u l k a n
meninggalkan	m ə n i ŋ ɡ a l k a n
meningkat	m ə n i ŋ k a t
meningkatkan	m ə n i ŋ k a t k a n
meningkatnya	m ə n i ŋ k a t ɲ a
meninjau	m ə n i n dʒ aʊ
menirukan	m ə n i r u k a n
menit	m ɛ n i t
meniup	m ə n i u p
menjabat	m ə n dʒ a b a t
menjadi	m ə n dʒ a d i
menjaga	m ə n dʒ a ɡ a
menjalani	m ə n dʒ a l a n i
menjawab	m ə n dʒ a w a b
menjebol	m ə n dʒ ɛ b o l
menjegal	m ə n dʒ ɛ ɡ a l
menjelang	m ə n dʒ ɛ l a ŋ
menjelaskan	m ə n dʒ ə l a s k a n
menjenguk	m ə n dʒ ɛ ŋ u k
menjual	m ə n dʒ u a l
menjurus	m ə n dʒ u r u s
menkeu	m ə n k ɛ u
menko	m ɛ n k o
menlu	m ɛ n l u
menneg	m ɛ n n ə ɡ
menodongkan	m ə n o d o ŋ k a n
menolak	m ə n o l a k
menolong	m ə n o l o ŋ
menperindag	m ə n p ə r i n d a ɡ
mensesneg	m ə n s ɛ s n ə ɡ
mensos	m ɛ n s o s
mensurvei	m ə n s u r v ɛ i
mensyukuri	m ə n ç u k u r i
mental	m ɛ n t a l
mentalnya	m ə n t a l ɲ a
menteng	m ɛ n t ə ŋ
menteri	m ə n t ɛ r i
menterinya	m ə n t ə r i ɲ a
menu	m ɛ n u
menuai	m ə n u aɪ
menuggu	m ə n u ɡ ɡ u
menuju	m ə n u dʒ u
menulis	m ə n u l i s
menumbangkan	m ə n u m b a ŋ k a n
menunaikan	m ə n u n aɪ k a n
menunda	m ə n u n d a
menungging-nungging	m ə n u ŋ ɡ i ŋ n u ŋ ɡ i ŋ
menunggu	m ə n u ŋ ɡ u
menunggunya	m ə n u ŋ ɡ u ɲ a
menunjuk	m ə n u n dʒ u k
menunjukkan	m ə n u n dʒ u k k a n
menuntut	m ə n u n t u t
menuntutnya	m ə n u n t u t ɲ a
menurunkan	m ə n u r u n k a n
menurut	m ə n u r u t
menusuk	m ə n u s u k
menutup	m ə n u t u p
menuturkan	m ə n u t u r k a n
menyadari	m ə ɲ a d a r i
menyaksikan	m ə ɲ a k s i k a n
menyamakan	m ə ɲ a m a k a n
menyambut	m ə ɲ a m b u t
menyanggupi	m ə ɲ a ŋ ɡ u p i
menyangkal	m ə ɲ a ŋ k a l
menyangkut	m ə ɲ a ŋ k u t
menyapu	m ə ɲ a p u
menyarankan	m ə ɲ a r a n k a n
menyatakan	m ə ɲ a t a k a n
menyayangi	m ə ɲ a j a ŋ i
menyayangkan	m ə ɲ a j a ŋ k a n
menyebabkan	m ə ɲ ə b a b k a n
menyeberangi	m ə ɲ ɛ b ə r a ŋ i
menyebut	m ə ɲ ɛ b u t
menyebut-nyebut	m ə ɲ ɛ b u t ɲ ɛ b u t
menyebutkan	m ə ɲ ə b u t k a n
menyediakan	m ə ɲ ɛ d i a k a n
menyegel	m ə ɲ ɛ ɡ ə l
menyeka	m ə ɲ ɛ k a
menyelip	m ə ɲ ɛ l i p
menyender	m ə ɲ ɛ n d ə r
menyentuh	m ə ɲ ɛ n t u h
menyerah	m ə ɲ ɛ r a h
menyerahkan	m ə ɲ ə r a h k a n
menyerang	m ə ɲ ɛ r a ŋ
menyeret	m ə ɲ ɛ r ə t
menyeringai	m ə ɲ ə r i ŋ aɪ
menyesal	m ə ɲ ɛ s a l
menyesalkan	m ə ɲ ə s a l k a n
menyetel	m ə ɲ ɛ t ə l
menyetopnya	m ə ɲ ə t o p ɲ a
menyewa	m ə ɲ ɛ w a
menyiapkan	m ə ɲ i a p k a n
menyibakkan	m ə ɲ i b a k k a n
menyindir	m ə ɲ i n d i r
menyinggung	m ə ɲ i ŋ ɡ u ŋ
menyingsing	m ə ɲ i ŋ s i ŋ
menyitir	m ə ɲ i t i r
menyocokkan	m ə ɲ o tʃ o k k a n
menyodorkan	m ə ɲ o d ɔ r k a n
menyogok	m ə ɲ o ɡ o k
menyongsong	m ə ɲ o ŋ s o ŋ
menyontohkan	m ə ɲ o n t o h k a n
menyoroti	m ə ɲ ɔ r o t i
menyosialisasikan	m ə ɲ o s i a l i s a s i k a n
menyuap	m ə ɲ u a p
menyuburkan	m ə ɲ u b u r k a n
menyucikan	m ə ɲ u tʃ i k a n
menyudutkan	m ə ɲ u d u t k a n
menyuguhkan	m ə ɲ u ɡ u h k a n
menyukai	m ə ɲ u k aɪ
menyundul	m ə ɲ u n d u l
menyurvei	m ə ɲ u r v ɛ i
menyusui	m ə ɲ u s u i
mepet	m ɛ p ə t
merah	m ɛ r a h
meraih	m ɛ r aɪ h
merambah	m ə r a m b a h
merampok	m ə r a m p o k
meramu	m ə r a m u
merangkul	m ə r a ŋ k u l
merangsek	m ə r a ŋ s ə k
merapi	m ə r a p i
merasa	m ə r a s a
merauke	m ə r aʊ k ə
merawatnya	m ə r a w a t ɲ a
merayakan	m ə r a j a k a n
merdeka	m ə r d ɛ k a
merealisasi	m ə r ɛ a l i s a s i
merecoki	m ə r ə tʃ o k i
mereda	m ə r ɛ d a
merek	m ɛ r ə k
mereka	m ə r ɛ k a
mereknya	m ə r ɛ k ɲ a
merenggut	m ə r ɛ ŋ ɡ u t
meresahkan	m ə r ə s a h k a n
merespons	m ə r ɛ s p o n s
meresponsnya	m ə r ə s p o n s ɲ a
merinci	m ə r i n tʃ i
merobek	m ə r o b ə k
merombak	m ə r o m b a k
merosot	m ə r o s o t
merugi	m ə r u ɡ i
merugikan	m ə r u ɡ i k a n
merupakan	m ə r u p a k a n
mesin	m ɛ s i n
mesiu	m ə s i u
mesjid	m ɛ ç i d
meski	m ɛ s k i
meskipun	m ə s k i p u n
mesti	m ɛ s t i
mestinya	m ə s t i ɲ a
metalik	m ə t a l i k
metode	m ə t o d ə
metro	m ɛ t r o
mewah	m ɛ w a h
mewakili	m ə w a k i l i
mewujudkan	m ə w u dʒ u d k a n
meyakini	m ə j a k i n i
mike	m i k ə
mikrofon	m i k r o f o n
milenium	m i l ə n i u m
milik	m i l i k
militer	m i l i t ə r
militeristik	m i l i t ə r i s t i k
minang	m i n a ŋ
minangkabau	m i n a ŋ k a b aʊ
mindanao	m i n d a n a o
minggu	m i ŋ ɡ u
mingguan	m i ŋ ɡ u a n
mini	m i n i
minimum	m i n i m u m
minta	m i n t a
minum	m i n u m
minuman	m i n u m a n
minyak	m i ɲ a k
minyaknya	m i ɲ a k ɲ a
mirip	m i r i p
mirip-mirip	m i r i p m i r i p
mirza	m i r z a
misa	m i s a
misalnya	m i s a l ɲ a
misi	m i s i
mistisnya	m i s t i s ɲ a
mlandangan	m l a n d a ŋ a n
mobil	m o b i l
mobilnya	m o b i l ɲ a
moceng	m o tʃ ə ŋ
mochtar	m o χ t a r
modal	m o d a l
mode	m o d ə
model	m o d ə l
moderator	m o d ə r a t ɔ r
modern	m o d ə r n
moerdiono	m u r d i o n o
moetojib	m u t o dʒ i b
mogok	m o ɡ o k
mohammed	m o h a m m ə d
mojokerto	m o dʒ o k ɛ r t o
molla	m o l a
molotov	m o l o t o v
momentum	m o m ɛ n t u m
moncong	m o n tʃ o ŋ
moneter	m o n ɛ t ə r
monica	m o n i tʃ a
monyet	m o ɲ ə t
moral	m ɔ r a l
mori	m ɔ r i
moro	m ɔ r o
motif-motif	m o t i f m o t i f
motor	m o t ɔ r
mozaik	m o z aɪ k
mpr	ɛ m p e ə r
mu	m u
muara	m u a r a
muarif	m u a r i f
muatannya	m u a t a n ɲ a
muchlis	m u χ l i s
muchsin	m u χ s i n
muchtar	m u χ t a r
mucit	m u tʃ i t
muda	m u d a
mudah	m u d a h
mudah-mudahan	m u d a h m u d a h a n
mufti	m u f t i
mugabe	m u ɡ a b ə
muhaimin	m u h aɪ m i n
muhammad	m u h a m m a d
muhiyi	m u h i j i
muhyi	m u h j i
mujab	m u dʒ a b
mukhtar	m u x t a r
mukjizat	m u k dʒ i z a t
mukti	m u k t i
mulai	m u l aɪ
mulkhan	m u l x a n
mullah	m u l a h
multipartai	m u l t i p a r t aɪ
mulut	m u l u t
mulyani	m u l j a n i
mulyono	m u l j o n o
mumpuni	m u m p u n i
mumu	m u m u
munaslub	m u n a s l u b
muncul	m u n tʃ u l
mundur	m u n d u r
mungkar	m u ŋ k a r
mungkin	m u ŋ k i n
munif	m u n i f
muntah	m u n t a h
murdwiono	m u r d w i o n o
murid	m u r i d
muridnya	m u r i d ɲ a
murni	m u r n i
murod	m u r o d
mursyid	m u r ç i d
murti	m u r t i
musa	m u s a
musibah	m u s i b a h
musik	m u s i k
muslim	m u s l i m
mustaine	m u s t aɪ n ə
mustofa	m u s t o f a
musuh	m u s u h
musyawarah	m u ç a w a r a h
mutlak	m u t l a k
mutmaen	m u t m a ə n
muzadi	m u z a d i
muzawi	m u z a w i
myanmar	m j a n m a r
nabi	n a b i
nabiel	n a b i l
nablus	n a b l u s
nadanya	n a d a ɲ a
nadi	n a d i
nafsu	n a f s u
nahi	n a h i
naik	n aɪ k
naikkan	n aɪ k k a n
najib	n a dʒ i b
nakata	n a k a t a
nakhwarian	n a x w a r i a n
nama	n a m a
namanya	n a m a ɲ a
namun	n a m u n
nanas	n a n a s
nano	n a n o
nanti	n a n t i
napi	n a p i
narasumber	n a r a s u m b ə r
narkotik	n a r k o t i k
nasdaq	n a s d a k
nasi	n a s i
nasib	n a s i b
nasibnya	n a s i b ɲ a
nasional	n a s i o n a l
naskah	n a s k a h
nasution	n a s u t i o n
nasyid	n a ç i d
natzir	n a t z i r
nawawi	n a w a w i
nawir	n a w i r
nazif	n a z i f
ndak	n d a k
ndoen	n d u n
negara	n ə ɡ a r a
negara-negara	n ə ɡ a r a n ə ɡ a r a
negatif	n ə ɡ a t i f
negeri	n ə ɡ ɛ r i
neis	n ɛ i s
neiss	n ɛ i s
nekad	n ɛ k a d
nekat	n ɛ k a t
nelayan	n ə l a j a n
nenek-nenek	n ɛ n ə k n ɛ n ə k
neo	n ɛ o
nepotisme	n ɛ p o t i s m ə
neraca	n ə r a tʃ a
nestapa	n ə s t a p a
netanyahu	n ɛ t a ɲ a h u
neto	n ɛ t o
netral	n ɛ t r a l
ngaco	ŋ a tʃ o
ngaku	ŋ a k u
ngalor-ngidul	ŋ a l ɔ r ŋ i d u l
nganjuk	ŋ a n dʒ u k
ngapain	ŋ a p aɪ n
ngarai	ŋ a r aɪ
ngasih	ŋ a s i h
ngaso	ŋ a s o
ngatijo	ŋ a t i dʒ o
ngatiyem	ŋ a t i j ə m
ngawal-ngawal	ŋ a w a l ŋ a w a l
ngawi	ŋ a w i
ngawur	ŋ a w u r
ngebut	ŋ ɛ b u t
ngebut-ngebutan	ŋ ɛ b u t ŋ ə b u t a n
ngecek	ŋ ɛ tʃ ə k
ngedrop	ŋ ɛ d r o p
ngelaba	ŋ ə l a b a
ngeloyor	ŋ ə l o j ɔ r
ngemil	ŋ ɛ m i l
ngemplang	ŋ ɛ m p l a ŋ
ngepul	ŋ ɛ p u l
ngeri	ŋ ɛ r i
ngerjain	ŋ ɛ r dʒ aɪ n
ngerti	ŋ ɛ r t i
ngerumpi	ŋ ə r u m p i
nggak	ŋ ɡ a k
nginden	ŋ i n d ə n
ngirit	ŋ i r i t
ngobrol-ngobrol	ŋ o b r o l ŋ o b r o l
ngojek	ŋ o dʒ ə k
ngomong	ŋ o m o ŋ
ngomong-ngomong	ŋ o m o ŋ ŋ o m o ŋ
ngomongnya	ŋ o m o ŋ ɲ a
ngotot	ŋ o t o t
nguping	ŋ u p i ŋ
ngurah	ŋ u r a h
ngurus	ŋ u r u s
ngurusin	ŋ u r u s i n
ngusman	ŋ u s m a n
nguyen	ŋ u j ə n
nias	n i a s
nigeria	n i ɡ ə r i a
nikah	n i k a h
nikko	n i k k o
nikmatilah	n i k m a t i l a h
nilai	n i l aɪ
nilai-nilai	n i l aɪ n i l aɪ
nilainya	n i l aɪ ɲ a
ninoy	n i n o j
nizar	n i z a r
njop	n dʒ o p
nominal	n o m i n a l
nominasi	n o m i n a s i
nomor	n o m ɔ r
non	n o n
non-aktif	n o n a k t i f
non-bujeter	n o n b u dʒ ɛ t ə r
non-fiskal	n o n f i s k a l
nonbudgeter	n o n b u d ɡ ɛ t ə r
normal	n ɔ r m a l
norwegia	n ɔ r w ə ɡ i a
noval	n o v a l
november	n o v ɛ m b ə r
novi	n o v i
novry	n o v r j
novum	n o v u m
noya	n o j a
ntb	ɛ n t e b e
nufail	n u f aɪ l
nugroho	n u ɡ r o h o
nulis	n u l i s
nunuz	n u n u z
nur	n u r
nurcholis	n u r χ o l i s
nurdin	n u r d i n
nurfaizi	n u r f aɪ z i
nurlif	n u r l i f
nursalim	n u r s a l i m
nurzein	n u r z ɛ i n
nusa	n u s a
nusaniwe	n u s a n i w ə
nusantara	n u s a n t a r a
nuwawea	n u w a w ɛ a
nyai	ɲ aɪ
nyanyi	ɲ a ɲ i
nyanyiannya	ɲ a ɲ i a n ɲ a
nyaring	ɲ a r i ŋ
nyaris	ɲ a r i s
nyasar	ɲ a s a r
nyatakan	ɲ a t a k a n
nyawa	ɲ a w a
nyekar	ɲ ɛ k a r
nyelonong	ɲ ə l o n o ŋ
nyenyak	ɲ ɛ ɲ a k
nyepi	ɲ ɛ p i
nyeri	ɲ ɛ r i
nyinyir	ɲ i ɲ i r
nyiur	ɲ i u r
nyolong	ɲ o l o ŋ
nyoman	ɲ o m a n
nyonya	ɲ o ɲ a
nyumbang	ɲ u m b a ŋ
nyungsep	ɲ u ŋ s ə p
obat	o b a t
objek	o b dʒ ə k
objektif	o b dʒ ɛ k t i f
obligasi	o b l i ɡ a s i
obligor	o b l i ɡ ɔ r
obor	o b ɔ r
obrolan	o b r o l a n
observer	o b s ɛ r v ə r
obstruktif	o b s t r u k t i f
obyek	o b j ə k
ocehan	o tʃ ɛ h a n
octavio	o tʃ t a v i o
ode	o d ə
oditur	o d i t u r
oebobo	u b o b o
oetomo	u t o m o
ofensif	o f ɛ n s i f
ofisial	o f i s i a l
ogah	o ɡ a h
ogoh-ogoh	o ɡ o h o ɡ o h
oh	o h
oikumene	o i k u m ɛ n ə
ojek	o dʒ ə k
oji	o dʒ i
oka	o k a
oke	o k ə
okinawa	o k i n a w a
oknum	o k n u m
oktober	o k t o b ə r
olahan	o l a h a n
olahraga	o l a h r a ɡ a
oleh	o l ə h
olimpiade	o l i m p i a d ə
oman	o m a n
omar	o m a r
omega	o m ɛ ɡ a
omong	o m o ŋ
omzet	o m z ə t
oncom	o n tʃ o m
onderdil	o n d ɛ r d i l
ongko	o ŋ k o
ongkos	o ŋ k o s
onno	o n n o
operasi	o p ə r a s i
operet	o p ɛ r ə t
opik	o p i k
opini	o p i n i
optimis	o p t i m i s
optimistis	o p t i m i s t i s
oral	ɔ r a l
orang	ɔ r a ŋ
orang-orang	ɔ r a ŋ ɔ r a ŋ
orangnya	ɔ r a ŋ ɲ a
orangtuanya	ɔ r a ŋ t u a ɲ a
oranye	ɔ r a ɲ ə
orasi	ɔ r a s i
orba	ɔ r b a
orde	ɔ r d ə
order	ɔ r d ə r
organda	ɔ r ɡ a n d a
oriental	ɔ r i n t a l
orisinil	ɔ r i s i n i l
oscar	o s tʃ a r
osman	o s m a n
otak	o t a k
otda	o t d a
otomatis	o t o m a t i s
otonomi	o t o n o m i
otoparts	o t o p a r t s
overdosis	o v ə r d o s i s
ovidio	o v i d i o
owen	o w ə n
ozon	o z o n
ozy	o z j
pabrik	p a b r i k
pacet	p a tʃ ə t
pacu	p a tʃ u
pada	p a d a
padang	p a d a ŋ
padat	p a d a t
padmadi	p a d m a d i
padmadinata	p a d m a d i n a t a
pagi	p a ɡ i
pahit	p a h i t
pahlevi	p a h l ɛ v i
pailit	p aɪ l i t
pailitnya	p aɪ l i t ɲ a
pajak	p a dʒ a k
pak	p a k
pakai	p a k aɪ
pakaian	p a k aɪ a n
paket	p a k ə t
pakpahan	p a k p a h a n
paksa	p a k s a
palembang	p a l ɛ m b a ŋ
palestina	p a l ə s t i n a
paling	p a l i ŋ
paliudju	p a l i u dʒ u
palsu	p a l s u
palu	p a l u
pam	p a m
pameran	p a m ɛ r a n
pamflet	p a m f l ə t
pamor	p a m ɔ r
pan	p a n
panas	p a n a s
pancasila	p a n tʃ a s i l a
pandai	p a n d aɪ
pandang	p a n d a ŋ
pandangan	p a n d a ŋ a n
pandeglang	p a n d ɛ ɡ l a ŋ
panen	p a n ə n
pangaribuan	p a ŋ a r i b u a n
pangdam	p a ŋ d a m
panggil	p a ŋ ɡ i l
panggilan	p a ŋ ɡ i l a n
panggilannya	p a ŋ ɡ i l a n ɲ a
panggung	p a ŋ ɡ u ŋ
pangkalan	p a ŋ k a l a n
pangkostrad	p a ŋ k o s t r a d
pangkuan	p a ŋ k u a n
panglima	p a ŋ l i m a
panik	p a n i k
panitia	p a n i t i a
panjang	p a n dʒ a ŋ
panji-panji	p a n dʒ i p a n dʒ i
panser	p a n s ə r
pansus	p a n s u s
pantai	p a n t aɪ
pantas	p a n t a s
panti	p a n t i
papa	p a p a
papandayan	p a p a n d a j a n
papar	p a p a r
papua	p a p u a
para	p a r a
paraguay	p a r a ɡ u a j
parah	p a r a h
parama	p a r a m a
parameter	p a r a m ɛ t ə r
parau	p a r aʊ
parawansa	p a r a w a n s a
pardede	p a r d ɛ d ə
paripurna	p a r i p u r n a
paris	p a r i s
parkir	p a r k i r
parlemen	p a r l ɛ m ə n
partai	p a r t aɪ
partai-partai	p a r t aɪ p a r t aɪ
partainya	p a r t aɪ ɲ a
parti	p a r t i
paru	p a r u
pas	p a s
pasang	p a s a ŋ
pasangan	p a s a ŋ a n
pasar	p a s a r
pasca	p a s tʃ a
pascagempa	p a s tʃ a ɡ ɛ m p a
pasif	p a s i f
pasifik	p a s i f i k
pasir	p a s i r
paskah	p a s k a h
paskibra	p a s k i b r a
pasti	p a s t i
pastikan	p a s t i k a n
pastilah	p a s t i l a h
pasukan	p a s u k a n
pasukannya	p a s u k a n ɲ a
patah	p a t a h
pati	p a t i
patra	p a t r a
paulus	p aʊ l u s
pawai	p a w aɪ
payau	p a j aʊ
pbb	p e b e b e
pbnu	p b n u
pdi	p d i
pdi-perjuangan	p d i p ə r dʒ u a ŋ a n
pdip	p d i p
peang	p ɛ a ŋ
pebulu	p ə b u l u
pecah	p ɛ tʃ a h
pecel	p ɛ tʃ ə l
peci	p ɛ tʃ i
pedagang	p ə d a ɡ a ŋ
pedalaman	p ə d a l a m a n
peduli	p ə d u l i
pegangan	p ə ɡ a ŋ a n
pegawai	p ə ɡ a w aɪ
pegawai-pegawai	p ə ɡ a w aɪ p ə ɡ a w aɪ
pegawainya	p ə ɡ a w aɪ ɲ a
pegunungan	p ə ɡ u n u ŋ a n
pejabat	p ə dʒ a b a t
pekalongan	p ə k a l o ŋ a n
pekan	p ɛ k a n
pekerja	p ə k ɛ r dʒ a
pekerjaan	p ə k ə r dʒ a a n
pekerjaannya	p ə k ɛ r dʒ a a n ɲ a
pelajar	p ə l a dʒ a r
pelaksananya	p ə l a k s a n a ɲ a
pelaku	p ə l a k u
pelakunya	p ə l a k u ɲ a
pelanggaran	p ə l a ŋ ɡ a r a n
pelantikan	p ə l a n t i k a n
pelatih	p ə l a t i h
pelayan	p ə l a j a n
pelecehan	p ə l ə tʃ ɛ h a n
pelemparan	p ə l ə m p a r a n
peluang-peluang	p ə l u a ŋ p ə l u a ŋ
peluit	p ə l u i t
peluru	p ə l u r u
pemain	p ɛ m aɪ n
pemain-pemain	p ɛ m aɪ n p ɛ m aɪ n
pemakainya	p ə m a k aɪ ɲ a
pemalsu	p ə m a l s u
pemancar	p ə m a n tʃ a r
pemandu	p ə m a n d u
pemangkasan	p ə m a ŋ k a s a n
pembacaan	p ə m b a tʃ a a n
pembahasannya	p ə m b a h a s a n ɲ a
pembangunan	p ə m b a ŋ u n a n
pembayaran	p ə m b a j a r a n
pembela	p ə m b ɛ l a
pembelaan	p ə m b ə l a a n
pembeli	p ə m b ɛ l i
pembelian	p ə m b ə l i a n
pembentukan	p ə m b ə n t u k a n
pemberian	p ə m b ə r i a n
pembiayaan	p ɛ m b i a j a a n
pembina	p ə m b i n a
pembinaan	p ə m b i n a a n
pemborong	p ə m b ɔ r o ŋ
pembuangan	p ə m b u a ŋ a n
pembuatan	p ə m b u a t a n
pembubaran	p ə m b u b a r a n
pembukaan	p ə m b u k a a n
pembuluh	p ə m b u l u h
pemda	p ɛ m d a
pemdaprov	p ə m d a p r o v
pemenang	p ə m ɛ n a ŋ
pemeriksaan	p ə m ɛ r i k s a a n
pemerintah	p ə m ə r i n t a h
pemerintahan	p ə m ɛ r i n t a h a n
pemilihan	p ə m i l i h a n
pemilik	p ə m i l i k
pemilu	p ə m i l u
pemimpin	p ə m i m p i n
pemimpinnya	p ə m i m p i n ɲ a
pemindahan	p ə m i n d a h a n
pemkab	p ɛ m k a b
pemkot	p ɛ m k o t
pemprov	p ɛ m p r o v
pemred	p ɛ m r ə d
pemuda	p ə m u d a
pemujaan	p ə m u dʒ a a n
pemulihan	p ə m u l i h a n
penahanan	p ə n a h a n a n
penambang	p ə n a m b a ŋ
penampilan	p ə n a m p i l a n
penanganan	p ə n a ŋ a n a n
penangkapan	p ə n a ŋ k a p a n
penasihat	p ə n a s i h a t
pencabutan	p ə n tʃ a b u t a n
pencairan	p ə n tʃ aɪ r a n
pencalonan	p ə n tʃ a l o n a n
penculikan	p ə n tʃ u l i k a n
pendanaan	p ə n d a n a a n
pendapat	p ə n d a p a t
pendek	p ɛ n d ə k
pendemo	p ə n d ɛ m o
penderita	p ə n d ə r i t a
penderitaan	p ə n d ɛ r i t a a n
pendidik	p ə n d i d i k
pendidikan	p ə n d i d i k a n
penduduk	p ə n d u d u k
pendukungnya	p ə n d u k u ŋ ɲ a
penebangan	p ə n ə b a ŋ a n
peneduh	p ə n ɛ d u h
penegakan	p ə n ə ɡ a k a n
penegasan	p ə n ə ɡ a s a n
penekan	p ə n ɛ k a n
penengnya	p ə n ɛ ŋ ɲ a
penerangan	p ə n ə r a ŋ a n
penerbangan	p ə n ə r b a ŋ a n
penerimaan	p ə n ɛ r i m a a n
pengabaian	p ə ŋ a b aɪ a n
pengacara	p ə ŋ a tʃ a r a
pengadilan	p ə ŋ a d i l a n
pengagep	p ə ŋ a ɡ ə p
pengaman	p ə ŋ a m a n
pengamanan	p ə ŋ a m a n a n
pengambilan	p ə ŋ a m b i l a n
pengasuh	p ə ŋ a s u h
pengawasannya	p ə ŋ a w a s a n ɲ a
pengayom	p ə ŋ a j o m
pengcab	p ɛ ŋ tʃ a b
pengeboman	p ə ŋ ə b o m a n
pengecer	p ə ŋ ɛ tʃ ə r
pengedar	p ə ŋ ɛ d a r
pengekangan	p ə ŋ ə k a ŋ a n
pengelolaan	p ə ŋ ɛ l o l a a n
pengembang	p ə ŋ ɛ m b a ŋ
pengembangan	p ə ŋ ə m b a ŋ a n
pengemudi	p ə ŋ ə m u d i
pengenal	p ə ŋ ɛ n a l
pengerahan	p ə ŋ ə r a h a n
pengetahuan	p ə ŋ ɛ t a h u a n
pengganti	p ə ŋ ɡ a n t i
penggunaan	p ə ŋ ɡ u n a a n
penggunaannya	p ə ŋ ɡ u n a a n ɲ a
penghematan	p ə ŋ h ə m a t a n
penghentian	p ə ŋ h ə n t i a n
penghubung	p ə ŋ h u b u ŋ
pengibaran	p ə ŋ i b a r a n
pengikut	p ə ŋ i k u t
pengkhianat	p ə ŋ x i a n a t
pengobatan	p ə ŋ o b a t a n
pengolahan	p ə ŋ o l a h a n
penguasa	p ə ŋ u a s a
penguburan	p ə ŋ u b u r a n
pengucapan	p ə ŋ u tʃ a p a n
pengumuman	p ə ŋ u m u m a n
pengunduran	p ə ŋ u n d u r a n
pengungkapan	p ə ŋ u ŋ k a p a n
pengungsi	p ə ŋ u ŋ s i
pengungsian	p ə ŋ u ŋ s i a n
pengunjuk	p ə ŋ u n dʒ u k
pengunjung	p ə ŋ u n dʒ u ŋ
pengurusan	p ə ŋ u r u s a n
pengusaha	p ə ŋ u s a h a
pengusutan	p ə ŋ u s u t a n
penindakan	p ə n i n d a k a n
penjaminan	p ə n dʒ a m i n a n
penjelasan	p ə n dʒ ə l a s a n
penjual	p ə n dʒ u a l
penjualan	p ə n dʒ u a l a n
penolakan	p ə n o l a k a n
pensiunan	p ə n s i u n a n
pentagon	p ə n t a ɡ o n
penting	p ɛ n t i ŋ
penuh	p ɛ n u h
penumpang	p ə n u m p a ŋ
penuturannya	p ə n u t u r a n ɲ a
penyakit	p ə ɲ a k i t
penyanyi	p ə ɲ a ɲ i
penyayang	p ə ɲ a j a ŋ
penyebab	p ə ɲ ɛ b a b
penyegaran	p ə ɲ ə ɡ a r a n
penyehatan	p ə ɲ ə h a t a n
penyejuk	p ə ɲ ɛ dʒ u k
penyelenggara	p ə ɲ ɛ l ə ŋ ɡ a r a
penyelesaian	p ə ɲ ɛ l ə s aɪ a n
penyelewengan-penyelewengan	p ə ɲ ɛ l ə w ɛ ŋ a n p ə ɲ ɛ l ə w ɛ ŋ a n
penyelidik	p ə ɲ ə l i d i k
penyelundupan	p ə ɲ ɛ l u n d u p a n
penyempitan	p ə ɲ ə m p i t a n
penyerangan	p ə ɲ ə r a ŋ a n
penyerobotan	p ə ɲ ɛ r o b o t a n
penyewaan	p ə ɲ ə w a a n
penyewanya	p ə ɲ ə w a ɲ a
penyidik	p ə ɲ i d i k
penyimpangan	p ə ɲ i m p a ŋ a n
penyisihan	p ə ɲ i s i h a n
penyok	p ɛ ɲ o k
penyu	p ɛ ɲ u
penyuluhan	p ə ɲ u l u h a n
pepatah	p ə p a t a h
perahu-perahu	p ə r a h u p ə r a h u
peralatan	p ə r a l a t a n
perampok	p ə r a m p o k
perancis	p ə r a n tʃ i s
perang	p ə r a ŋ
perangai	p ə r a ŋ aɪ
peraturan	p ə r a t u r a n
perawatan	p ə r a w a t a n
perbaiki	p ə r b aɪ k i
perbankan	p ə r b a n k a n
perbatasan	p ə r b a t a s a n
perbedaan	p ə r b ə d a a n
perbuatan	p ə r b u a t a n
percakapan	p ə r tʃ a k a p a n
percaya	p ə r tʃ a j a
percobaan	p ə r tʃ o b a a n
perdagangan	p ə r d a ɡ a ŋ a n
perdamaian	p ə r d a m aɪ a n
perebut	p ə r ɛ b u t
perempuan	p ə r ə m p u a n
pergelaran	p ə r ɡ ə l a r a n
pergi	p ɛ r ɡ i
perhatian	p ə r h a t i a n
perhentian	p ə r h ə n t i a n
periklanan	p ə r i k l a n a n
perimbangan	p ə r i m b a ŋ a n
peringatan	p ə r i ŋ a t a n
peringkat	p ə r i ŋ k a t
perintis	p ə r i n t i s
periode	p ə r i o d ə
perisai	p ə r i s aɪ
peristiwa	p ə r i s t i w a
perjalanan	p ə r dʒ a l a n a n
perjalanannya	p ə r dʒ a l a n a n ɲ a
perjanjian	p ə r dʒ a n dʒ i a n
perjuangan	p ə r dʒ u a ŋ a n
perkasa	p ə r k a s a
perkataan	p ə r k a t a a n
perkembangan	p ə r k ə m b a ŋ a n
perkenalan	p ə r k ə n a l a n
perkosa	p ə r k o s a
perlawanan	p ə r l a w a n a n
perlu	p ɛ r l u
permai	p ɛ r m aɪ
permainan	p ə r m aɪ n a n
permaisuri	p ə r m aɪ s u r i
permasalahan	p ə r m a s a l a h a n
permintaan	p ə r m i n t a a n
permusuhan	p ə r m u s u h a n
pernah	p ɛ r n a h
pernyataan	p ə r ɲ a t a a n
perpecahan	p ə r p ə tʃ a h a n
perploncoan	p ə r p l o n tʃ o a n
perpu	p ɛ r p u
pers	p ə r s
persaingan	p ə r s aɪ ŋ a n
persebaya	p ə r s ə b a j a
perseroan	p ə r s ə r o a n
persiapan	p ə r s i a p a n
persikabo	p ə r s i k a b o
persis	p ɛ r s i s
persnya	p ɛ r s ɲ a
persoalan	p ə r s o a l a n
personel	p ə r s o n ə l
perspektif	p ə r s p ɛ k t i f
persyaratan	p ə r ç a r a t a n
pertama	p ə r t a m a
pertamina	p ə r t a m i n a
pertanyaan	p ə r t a ɲ a a n
pertemuan	p ə r t ə m u a n
pertengahan	p ə r t ə ŋ a h a n
perubahan	p ə r u b a h a n
perumahan	p ə r u m a h a n
perunggu	p ə r u ŋ ɡ u
perusahaan	p ə r u s a h a a n
perusahan	p ə r u s a h a n
perusahan-perusahaan	p ə r u s a h a n p ə r u s a h a a n
perusakan	p ə r u s a k a n
perut	p ɛ r u t
perwakilan	p ə r w a k i l a n
perwira	p ə r w i r a
pesanan	p ə s a n a n
pesantren	p ə s a n t r ə n
pesawat	p ə s a w a t
peserta	p ə s ɛ r t a
pesta	p ɛ s t a
petani	p ə t a n i
peter	p ɛ t ə r
peti	p ɛ t i
petikan	p ə t i k a n
petir	p ɛ t i r
petojo	p ə t o dʒ o
petro	p ɛ t r o
petroleum	p ə t r o l ɛ u m
petugas	p ə t u ɡ a s
pewarna	p ə w a r n a
peziarah	p ə z i a r a h
philipina	f i l i p i n a
piagam	p i a ɡ a m
piala	p i a l a
piaraan	p i a r a a n
pidato	p i d a t o
pidatonya	p i d a t o ɲ a
pidum	p i d u m
pihak	p i h a k
pihaknya	p i h a k ɲ a
pikir	p i k i r
pilih	p i l i h
pilihan	p i l i h a n
pilot	p i l o t
pilotnya	p i l o t ɲ a
pimpinan	p i m p i n a n
pimpinannya	p i m p i n a n ɲ a
pindah	p i n d a h
pinggang	p i ŋ ɡ a ŋ
pinjaman	p i n dʒ a m a n
pintar	p i n t a r
pinter	p i n t ə r
pintu	p i n t u
piringnya	p i r i ŋ ɲ a
pisau	p i s aʊ
pkb	p e k a b e
plastik	p l a s t i k
plat	p l a t
platform	p l a t f ɔ r m
plaza	p l a z a
pledoi	p l ə d o i
pledoinya	p l ɛ d o i ɲ a
pleidoi	p l ɛ i d o i
pleno	p l ɛ n o
pln	p e ə l ɛ n
plo	p l o
pluralisme	p l u r a l i s m ə
plus	p l u s
poco-poco	p o tʃ o p o tʃ o
podium	p o d i u m
pohon	p o h o n
pojok	p o dʒ o k
pokok	p o k o k
pokoknya	p o k o k ɲ a
polda	p o l d a
polemik	p o l ɛ m i k
polis	p o l i s
polisi	p o l i s i
politik	p o l i t i k
polkam	p o l k a m
polres	p o l r ə s
polri	p o l r i
polsek	p o l s ə k
polusi	p o l u s i
pom	p o m
pompa	p o m p a
ponco	p o n tʃ o
pondok	p o n d o k
ponorogo	p o n ɔ r o ɡ o
ponpes	p o n p ə s
pop	p o p
populer	p o p u l ə r
pornografi	p ɔ r n o ɡ r a f i
portfolio	p ɔ r t f o l i o
portugal	p ɔ r t u ɡ a l
pos	p o s
posisi	p o s i s i
posisinya	p o s i s i ɲ a
positif	p o s i t i f
posko	p o s k o
poso	p o s o
poster	p o s t ə r
posyandu	p o ç a n d u
potong	p o t o ŋ
pp	p e p e
prabowo	p r a b o w o
pradjoto	p r a dʒ o t o
pragmatis	p r a ɡ m a t i s
prakarsa	p r a k a r s a
pramono	p r a m o n o
prancis	p r a n tʃ i s
pranoto	p r a n o t o
prasangka	p r a s a ŋ k a
prasetyo	p r a s ɛ t j o
prawiro	p r a w i r o
prd	p e ə r d e
preman	p r ɛ m a n
premi	p r ɛ m i
premium	p r ə m i u m
prepcom	p r ɛ p tʃ o m
prerogatif	p r ɛ r o ɡ a t i f
presiden	p r ə s i d ə n
presisi	p r ə s i s i
presley	p r ɛ s l ə j
prestasi	p r ə s t a s i
prestasinya	p r ɛ s t a s i ɲ a
preventifnya	p r ɛ v ə n t i f ɲ a
pribadi	p r i b a d i
prihartono	p r i h a r t o n o
prihatin	p r i h a t i n
prinsipnya	p r i n s i p ɲ a
privatisasi	p r i v a t i s a s i
prj	p e ə r dʒ e
pro	p r o
pro-estrada	p r o ə s t r a d a
problem	p r o b l ə m
produk	p r o d u k
produksi	p r o d u k s i
produktif	p r o d u k t i f
profesionalisme	p r o f ə s i o n a l i s m ə
profil	p r o f i l
program	p r o ɡ r a m
progresif	p r o ɡ r ɛ s i f
proklamasi	p r o k l a m a s i
promosi	p r o m o s i
propinsi	p r o p i n s i
proporsional	p r o p ɔ r s i o n a l
prosedur	p r o s ɛ d u r
proses	p r o s ə s
proteksi	p r o t ɛ k s i
protes	p r o t ə s
protokol	p r o t o k o l
provinsi	p r o v i n s i
provokator	p r o v o k a t ɔ r
provost	p r o v o s t
proyek	p r o j ə k
proyek-proyek	p r o j ə k p r o j ə k
pseudodemokrasi	p s ɛ u d o d ə m o k r a s i
psikiater	p s i k i a t ə r
psikisnya	p s i k i s ɲ a
psikolog	p s i k o l o ɡ
psikologis	p s i k o l o ɡ i s
psikotropika	p s i k o t r o p i k a
psm	p e ə s ɛ m
pssi	p s i
pt	p e t e
puas	p u a s
puasa	p u a s a
publik	p u b l i k
pucuk	p u tʃ u k
puing-puing	p u i ŋ p u i ŋ
puji	p u dʒ i
pujobroto	p u dʒ o b r o t o
pukat	p u k a t
pula	p u l a
pulang	p u l a ŋ
pulau	p u l aʊ
pulaunya	p u l aʊ ɲ a
puluh	p u l u h
puluhan	p u l u h a n
pun	p u n
puncak	p u n tʃ a k
punya	p u ɲ a
pupuk	p u p u k
purba	p u r b a
purnomo	p u r n o m o
purwoatmodjo	p u r w o a t m o dʒ o
pusaka	p u s a k a
pusat	p u s a t
pusing	p u s i ŋ
puslabfor	p u s l a b f ɔ r
puspoyo	p u s p o j o
putar	p u t a r
putaw	p u t a w
puteh	p u t ə h
putih	p u t i h
putri	p u t r i
putro	p u t r o
putu	p u t u
putus	p u t u s
putusan	p u t u s a n
puyuh	p u j u h
qatar	k a t a r
qomari	k o m a r i
quo	k w o
rabu	r a b u
rachbini	r a χ b i n i
rachmad	r a χ m a d
rachmaningsih	r a χ m a n i ŋ s i h
racun	r a tʃ u n
radar	r a d a r
radio	r a d i o
radionya	r a d i o ɲ a
ragam	r a ɡ a m
rahardjo	r a h a r dʒ o
rahasia	r a h a s i a
rahman	r a h m a n
rahmat	r a h m a t
rais	r aɪ s
raja	r a dʒ a
rajasa	r a dʒ a s a
rajin	r a dʒ i n
raka	r a k a
rakitan	r a k i t a n
raksasa	r a k s a s a
rakyat	r a k j a t
ramah	r a m a h
ramai	r a m aɪ
ramai-ramai	r a m aɪ r a m aɪ
ramako	r a m a k o
ramallah	r a m a l a h
rambut	r a m b u t
ramdlon	r a m d l o n
rame-rame	r a m ə r a m ə
ramelow	r a m ɛ l o w
ramli	r a m l i
rampok	r a m p o k
rancaekek	r a n tʃ a ɛ k ə k
rangkaian	r a ŋ k aɪ a n
ranjang	r a n dʒ a ŋ
ranjau	r a n dʒ aʊ
ransel	r a n s ə l
rantap	r a n t a p
rantau	r a n t aʊ
rapat	r a p a t
rapbn	r a p b n
rapel	r a p ə l
rasa	r a s a
rasio	r a s i o
rasyid	r a ç i d
rata	r a t a
ratna	r a t n a
ratusan	r a t u s a n
raungan	r aʊ ŋ a n
rawan	r a w a n
raweyai	r a w ɛ j aɪ
raya	r a j a
rayunya	r a j u ɲ a
re-ekspor	r ɛ ə k s p ɔ r
realisasi	r ɛ a l i s a s i
realitas	r ɛ a l i t a s
rebo	r ɛ b o
refleksi	r ə f l ɛ k s i
reformasi	r ɛ f ɔ r m a s i
regenerasi	r ɛ ɡ ə n ə r a s i
regional	r ɛ ɡ i o n a l
regu	r ɛ ɡ u
reguler	r ə ɡ u l ə r
rejang	r ɛ dʒ a ŋ
rejeki	r ə dʒ ɛ k i
rejim	r ɛ dʒ i m
rekaman	r ə k a m a n
rekan-rekannya	r ɛ k a n r ə k a n ɲ a
rekening	r ɛ k ə n i ŋ
reklame	r ə k l a m ə
rekomendasi	r ɛ k o m ə n d a s i
rekrutmen	r ə k r u t m ə n
rektor	r ɛ k t ɔ r
rel	r ɛ l
relatif	r ə l a t i f
relevansi	r ɛ l ə v a n s i
relung	r ɛ l u ŋ
rem	r ɛ m
rem-rem	r ɛ m r ɛ m
remaja	r ə m a dʒ a
rembug	r ɛ m b u ɡ
remeh	r ɛ m ə h
remis	r ɛ m i s
remnya	r ɛ m ɲ a
rencana	r ə n tʃ a n a
rencanakan	r ɛ n tʃ a n a k a n
rencananya	r ɛ n tʃ a n a ɲ a
rendah	r ɛ n d a h
rendahnya	r ə n d a h ɲ a
renny	r ɛ n ɲ
rentang	r ɛ n t a ŋ
renungan	r ə n u ŋ a n
reog	r ɛ o ɡ
repot	r ɛ p o t
represif	r ə p r ɛ s i f
republik	r ə p u b l i k
resah	r ɛ s a h
reserse	r ə s ɛ r s ə
resiko	r ə s i k o
resmi	r ɛ s m i
responden	r ə s p o n d ə n
respons	r ɛ s p o n s
restoran	r ə s t ɔ r a n
revisi	r ə v i s i
revolver	r ə v o l v ə r
rewel	r ɛ w ə l
reyot	r ɛ j o t
reza	r ɛ z a
rezeki	r ə z ɛ k i
rezekinya	r ɛ z ə k i ɲ a
rezim	r ɛ z i m
rezlan	r ɛ z l a n
ri	r i
riau	r i aʊ
ribu	r i b u
ribuan	r i b u a n
ricuh	r i tʃ u h
ridwan	r i d w a n
rifqi	r i f k i
rinci	r i n tʃ i
rincian	r i n tʃ i a n
ring	r i ŋ
ringan	r i ŋ a n
rining	r i n i ŋ
risau	r i s aʊ
risiko	r i s i k o
ristek	r i s t ə k
riswandha	r i s w a n d h a
ritme	r i t m ə
riuh	r i u h
riwud	r i w u d
riwut	r i w u t
rizal	r i z a l
rizalt	r i z a l t
rizieq	r i z i k
rizki	r i z k i
rizwa	r i z w a
robek	r o b ə k
rochim	r o χ i m
rochjana	r o χ dʒ a n a
rochman	r o χ m a n
roda	r o d a
roh	r o h
rohaniwan	r o h a n i w a n
rohman	r o h m a n
rois	r o i s
rok	r o k
rokok	r o k o k
roma	r o m a
rombongan	r o m b o ŋ a n
romy	r o m j
ronde	r o n d ə
roni	r o n i
rosbiri	r o s b i r i
rossyati	r o s j a t i
rosyid	r o ç i d
rotan	r o t a n
roy	r o j
royong	r o j o ŋ
rrc	ɛ r ɛ r tʃ e
rs	ɛ r ɛ s
rscm	ɛ r ɛ s tʃ e ə m
rsud	r s u d
rt	ɛ r t e
ruang	r u a ŋ
ruangan	r u a ŋ a n
ruangannya	r u a ŋ a n ɲ a
ruby	r u b j
ruchyat	r u χ j a t
ruci	r u tʃ i
rudal	r u d a l
rudi	r u d i
rudolf	r u d o l f
rudolph	r u d o l f
rugi	r u ɡ i
rukayah	r u k a j a h
ruke	r u k ə
rully	r u l j
rumah	r u m a h
rumahnya	r u m a h ɲ a
rumbewas	r u m b ɛ w a s
rumlus	r u m l u s
rumsfeld	r u m s f ə l d
runding	r u n d i ŋ
runtuh	r u n t u h
rupanya	r u p a ɲ a
rupiah	r u p i a h
rusak	r u s a k
rusdi	r u s d i
rusdiharjo	r u s d i h a r dʒ o
rutan	r u t a n
rute	r u t ə
ruu	r u u
ruwet	r u w ə t
rw	ɛ r w e
ryacudu	r j a tʃ u d u
ryamizard	r j a m i z a r d
saat	s a a t
sabarno	s a b a r n o
sabetan	s a b ɛ t a n
sabirin	s a b i r i n
sabtu	s a b t u
sabut	s a b u t
saddam	s a d d a m
sae	s a ə
safari	s a f a r i
safuan	s a f u a n
sah	s a h
sah-sah	s a h s a h
sahabat	s a h a b a t
saham	s a h a m
sahid	s a h i d
sailendra	s aɪ l ɛ n d r a
saja	s a dʒ a
sajak-sajaknya	s a dʒ a k s a dʒ a k ɲ a
sakit	s a k i t
saksi	s a k s i
saksi-saksi	s a k s i s a k s i
sakti	s a k t i
salah	s a l a h
salam	s a l a m
saldo	s a l d o
saleh	s a l ə h
salemba	s a l ɛ m b a
saling	s a l i ŋ
sama	s a m a
sama-sama	s a m a s a m a
sambil	s a m b i l
sambuaga	s a m b u a ɡ a
sambung	s a m b u ŋ
samodra	s a m o d r a
sampai	s a m p aɪ
sampaikan	s a m p aɪ k a n
sampainya	s a m p aɪ ɲ a
sampang	s a m p a ŋ
sampeyan	s a m p ɛ j a n
samping	s a m p i ŋ
sampit	s a m p i t
sanak	s a n a k
sang	s a ŋ
sangat	s a ŋ a t
sanggup	s a ŋ ɡ u p
sangu	s a ŋ u
santai	s a n t aɪ
santosa	s a n t o s a
sanur	s a n u r
sapi	s a p i
sapta	s a p t a
sapu	s a p u
sapuan	s a p u a n
saran	s a r a n
sarawak	s a r a w a k
sarwono	s a r w o n o
sasarannya	s a s a r a n ɲ a
sate	s a t ə
satpol	s a t p o l
satrio	s a t r i o
satu	s a t u
satu-satunya	s a t u s a t u ɲ a
satuan	s a t u a n
satunya	s a t u ɲ a
saudara	s aʊ d a r a
saudaranya	s aʊ d a r a ɲ a
sawo	s a w o
saya	s a j a
sayang	s a j a ŋ
sayap	s a j a p
sayed	s a j ə d
sayur-mayur	s a j u r m a j u r
seabad	s ə a b a d
seaman	s ə a m a n
seandainya	s ə a n d aɪ ɲ a
sebab	s ɛ b a b
sebabnya	s ə b a b ɲ a
sebagai	s ə b a ɡ aɪ
sebagainya	s ə b a ɡ aɪ ɲ a
sebagian	s ə b a ɡ i a n
sebaik-baiknya	s ɛ b aɪ k b aɪ k ɲ a
sebaiknya	s ə b aɪ k ɲ a
sebaliknya	s ə b a l i k ɲ a
sebelah	s ə b ɛ l a h
sebelahnya	s ə b ə l a h ɲ a
sebelas	s ə b ɛ l a s
sebelum	s ə b ɛ l u m
sebelumnya	s ə b ə l u m ɲ a
sebenarnya	s ə b ə n a r ɲ a
seberat	s ə b ɛ r a t
sebetulnya	s ə b ə t u l ɲ a
sebuah	s ə b u a h
sebutlah	s ə b u t l a h
secara	s ə tʃ a r a
seda	s ɛ d a
sedan	s ɛ d a n
sedang	s ɛ d a ŋ
sedangkan	s ə d a ŋ k a n
sederhana	s ə d ə r h a n a
sediakan	s ə d i a k a n
sedikit	s ə d i k i t
sedunia	s ə d u n i a
sedyono	s ə d j o n o
sefrontal	s ə f r o n t a l
segala	s ə ɡ a l a
segala-galanya	s ə ɡ a l a ɡ a l a ɲ a
segan-segan	s ɛ ɡ a n s ɛ ɡ a n
segar	s ɛ ɡ a r
segera	s ə ɡ ɛ r a
segi	s ɛ ɡ i
sehari	s ə h a r i
seharusnya	s ə h a r u s ɲ a
sehat	s ɛ h a t
sehelai	s ə h ɛ l aɪ
sehingga	s ə h i ŋ ɡ a
sehubungan	s ə h u b u ŋ a n
sejago-jagonya	s ə dʒ a ɡ o dʒ a ɡ o ɲ a
sejak	s ɛ dʒ a k
sejalan	s ə dʒ a l a n
sejauh	s ɛ dʒ aʊ h
sejenis	s ə dʒ ɛ n i s
sejujurnya	s ə dʒ u dʒ u r ɲ a
sejuk	s ɛ dʒ u k
sejumlah	s ə dʒ u m l a h
sekadar	s ə k a d a r
sekali	s ə k a l i
sekalian	s ə k a l i a n
sekalipun	s ə k a l i p u n
sekarang	s ə k a r a ŋ
sekitar	s ə k i t a r
sekjen	s ɛ k dʒ ə n
sekneg	s ɛ k n ə ɡ
sekolah	s ə k o l a h
sekretaris	s ə k r ə t a r i s
seksi	s ɛ k s i
seksual	s ə k s u a l
sektor	s ɛ k t ɔ r
sekujur	s ə k u dʒ u r
selain	s ɛ l aɪ n
selaku	s ə l a k u
selalu	s ə l a l u
selam	s ɛ l a m
selama	s ə l a m a
selamat	s ə l a m a t
selamatan	s ə l a m a t a n
selanjutnya	s ə l a n dʒ u t ɲ a
selatan	s ə l a t a n
selektif	s ə l ɛ k t i f
selepas	s ə l ɛ p a s
selesai	s ə l ɛ s aɪ
selesai-selesai	s ə l ɛ s aɪ s ə l ɛ s aɪ
selezat	s ə l ɛ z a t
selidiki	s ə l i d i k i
selisih	s ə l i s i h
selnya	s ɛ l ɲ a
seloroh	s ə l ɔ r o h
selulernya	s ə l u l ɛ r ɲ a
seluruh	s ə l u r u h
semakin	s ə m a k i n
semangat	s ə m a ŋ a t
semarak	s ə m a r a k
semasa	s ə m a s a
semata-mata	s ə m a t a m a t a
sembarangan	s ə m b a r a ŋ a n
sembari	s ə m b a r i
sembilan	s ə m b i l a n
sembunyi-sembunyi	s ə m b u ɲ i s ə m b u ɲ i
semen	s ɛ m ə n
sementara	s ə m ə n t a r a
seminggu	s ə m i ŋ ɡ u
sempat	s ɛ m p a t
sempit	s ɛ m p i t
sempurna	s ə m p u r n a
semua	s ə m u a
semuanya	s ə m u a ɲ a
semula	s ə m u l a
senada	s ə n a d a
senam	s ɛ n a m
senang	s ɛ n a ŋ
senantiasa	s ə n a n t i a s a
senator	s ə n a t ɔ r
sendiri	s ə n d i r i
senen	s ɛ n ə n
senewen	s ə n ɛ w ə n
sengaja	s ə ŋ a dʒ a
seni	s ɛ n i
senin	s ɛ n i n
senior	s ə n i ɔ r
senjata	s ə n dʒ a t a
seno	s ɛ n o
sentral	s ɛ n t r a l
sentralisme	s ə n t r a l i s m ə
seorang	s ə ɔ r a ŋ
sepak	s ɛ p a k
sepakat	s ə p a k a t
sepanjang	s ə p a n dʒ a ŋ
sepatu	s ə p a t u
sepeda	s ə p ɛ d a
seperti	s ə p ɛ r t i
sepihak	s ə p i h a k
sepotong	s ə p o t o ŋ
seprei	s ə p r ɛ i
sepuluh	s ə p u l u h
sepupu	s ə p u p u
seputar	s ə p u t a r
sepyati	s ə p j a t i
serahkan	s ə r a h k a n
serangan	s ə r a ŋ a n
seraya	s ə r a j a
serfianus	s ə r f i a n u s
sergah	s ɛ r ɡ a h
sergapan	s ə r ɡ a p a n
sergei	s ə r ɡ ɛ i
seri	s ɛ r i
seribu	s ə r i b u
serikat	s ə r i k a t
sering	s ɛ r i ŋ
serius	s ə r i u s
serpong	s ɛ r p o ŋ
serse	s ɛ r s ə
serta	s ɛ r t a
serta-merta	s ɛ r t a m ɛ r t a
sertu	s ɛ r t u
seruan	s ə r u a n
serupa	s ə r u p a
sesaat	s ə s a a t
sesal	s ɛ s a l
sesalkan	s ə s a l k a n
seseorang	s ə s ə ɔ r a ŋ
sesuai	s ə s u aɪ
set	s ɛ t
setelah	s ə t ɛ l a h
setempat	s ə t ɛ m p a t
seterusnya	s ə t ə r u s ɲ a
setiap	s ə t i a p
setibanya	s ə t i b a ɲ a
setneg	s ɛ t n ə ɡ
setuju	s ə t u dʒ u
seusai	s ə u s aɪ
sewa	s ɛ w a
sewaktu	s ə w a k t u
sewenang-wenang	s ə w ɛ n a ŋ w ɛ n a ŋ
sewot	s ɛ w o t
sewu	s ɛ w u
seyogyanya	s ə j o ɡ j a ɲ a
shafwan	s h a f w a n
shanghai	s h a ŋ h aɪ
shanty	s h a n t j
sheikh	s h ɛ i x
shihab	s h i h a b
sholat	s h o l a t
shou	s h o u
si	s i
siahaan	s i a h a a n
siangnya	s i a ŋ ɲ a
siap	s i a p
siapa	s i a p a
siaran	s i a r a n
sidang	s i d a ŋ
sidik	s i d i k
sidoarjo	s i d o a r dʒ o
sifat	s i f a t
sigit	s i ɡ i t
signifikan	s i ɡ n i f i k a n
sih	s i h
sihaloho	s i h a l o h o
sikap	s i k a p
silahkan	s i l a h k a n
silahturahmi	s i l a h t u r a h m i
silakan	s i l a k a n
silam	s i l a m
silitonga	s i l i t o ŋ a
siliwangi	s i l i w a ŋ i
sim	s i m
simatupang	s i m a t u p a ŋ
simbol	s i m b o l
simbol-simbol	s i m b o l s i m b o l
simeon	s i m ɛ o n
simon	s i m o n
sinaga	s i n a ɡ a
sinar	s i n a r
sinatra	s i n a t r a
sinay	s i n a j
sindang	s i n d a ŋ
sineas	s i n ɛ a s
singapura	s i ŋ a p u r a
singgah	s i ŋ ɡ a h
singkat	s i ŋ k a t
sini	s i n i
sinjai	s i n dʒ aɪ
sintuwu	s i n t u w u
sinyo	s i ɲ o
sipil	s i p i l
sipir	s i p i r
sirine	s i r i n ə
siringo-ringo	s i r i ŋ o r i ŋ o
sisanya	s i s a ɲ a
sistem	s i s t ə m
siswi	s i s w i
siswono	s i s w o n o
siswoyo	s i s w o j o
siti	s i t i
situ	s i t u
situasi	s i t u a s i
situlah	s i t u l a h
situmorang	s i t u m ɔ r a ŋ
situs	s i t u s
siwi	s i w i
sjachriel	ç a χ r i l
sjafrie	ç a f r i
sk	ɛ s k a
skema	s k ɛ m a
skenario	s k ə n a r i o
skeptis	s k ɛ p t i s
sketsa	s k ɛ t s a
skotlandia	s k o t l a n d i a
slamet	s l a m ə t
slawi	s l a w i
sleman	s l ɛ m a n
slipi	s l i p i
slovenia	s l o v ə n i a
sltp	ɛ s ɛ l t e p e
smith	s m i t h
smp	ɛ s ɛ m p e
sms	ɛ s ɛ m ɛ s
smu	s m u
soal	s o a l
soal-soal	s o a l s o a l
soebowo	s u b o w o
soedarso	s u d a r s o
soeharto	s u h a r t o
soekarno	s u k a r n o
soekarnoputri	s u k a r n o p u t r i
soetandyo	s u t a n d j o
soewondo	s u w o n d o
sofian	s o f i a n
sofyan	s o f j a n
sohih	s o h i h
solekhah	s o l ɛ x a h
solichin	s o l i χ i n
solo	s o l o
solvabilitas	s o l v a b i l i t a s
somalia	s o m a l i a
sony	s o ɲ
sopirnya	s o p i r ɲ a
sorai	s ɔ r aɪ
sorak	s ɔ r a k
sore	s ɔ r ə
sorenya	s ɔ r ɛ ɲ a
sosial	s o s i a l
sosiolog	s o s i o l o ɡ
sosok	s o s o k
soto	s o t o
soulisa	s o u l i s a
spanduk	s p a n d u k
spanyol	s p a ɲ o l
spekulan	s p ə k u l a n
spesial	s p ə s i a l
spesies	s p ɛ s i s
spesifik	s p ə s i f i k
spinghar	s p i ŋ h a r
sragen	s r a ɡ ə n
sreg	s r ɛ ɡ
sri	s r i
srie	s r i
sriwedari	s r i w ə d a r i
stabil	s t a b i l
staf	s t a f
stafnya	s t a f ɲ a
stagnasi	s t a ɡ n a s i
stamina	s t a m i n a
stasiun	s t a s i u n
status	s t a t u s
statusnya	s t a t u s ɲ a
stenli	s t ɛ n l i
stie	s t i
stigma	s t i ɡ m a
stm	ɛ s t e ə m
stok	s t o k
stop	s t o p
strategi	s t r a t ɛ ɡ i
struktur	s t r u k t u r
suaeb	s u a ə b
suai	s u aɪ
suaib	s u aɪ b
suami	s u a m i
suaminya	s u a m i ɲ a
suara	s u a r a
suaranya	s u a r a ɲ a
suasana	s u a s a n a
suatu	s u a t u
sub	s u b
subagya	s u b a ɡ j a
subagyo	s u b a ɡ j o
subarjo	s u b a r dʒ o
subcerita	s u b tʃ ə r i t a
subduksi	s u b d u k s i
subiyakto	s u b i j a k t o
subseksi	s u b s ɛ k s i
subtropis	s u b t r o p i s
subversi	s u b v ɛ r s i
sucipto	s u tʃ i p t o
sudah	s u d a h
sudarto	s u d a r t o
sudibyo	s u d i b j o
sudirman	s u d i r m a n
sudrajat	s u d r a dʒ a t
sudut	s u d u t
sudwikatmono	s u d w i k a t m o n o
sueb	s u ə b
sufyan	s u f j a n
sugeng	s u ɡ ə ŋ
sugiyanto	s u ɡ i j a n t o
sugyati	s u ɡ j a t i
suharsono	s u h a r s o n o
suharsoyo	s u h a r s o j o
suharto	s u h a r t o
suhu	s u h u
suhunya	s u h u ɲ a
sujud	s u dʒ u d
suka	s u k a
sukandar	s u k a n d a r
sukarnoputri	s u k a r n o p u t r i
sukorejo	s u k ɔ r ɛ dʒ o
sukses	s u k s ə s
suku	s u k u
sulaeman	s u l a ɛ m a n
sulaiman	s u l aɪ m a n
sulawesi	s u l a w ɛ s i
sulistio	s u l i s t i o
sulit	s u l i t
sulsel	s u l s ə l
sultan	s u l t a n
sulteng	s u l t ə ŋ
sumargono	s u m a r ɡ o n o
sumarno	s u m a r n o
sumatera	s u m a t ɛ r a
sumbangan	s u m b a ŋ a n
sumber	s u m b ə r
sumbernya	s u m b ɛ r ɲ a
sumur	s u m u r
sunda	s u n d a
sungai	s u ŋ aɪ
sungainya	s u ŋ aɪ ɲ a
sungguh	s u ŋ ɡ u h
sungguh-sunguh	s u ŋ ɡ u h s u ŋ u h
sunter	s u n t ə r
sunyoto	s u ɲ o t o
supaya	s u p a j a
superintenden	s u p ə r i n t ɛ n d ə n
suplai	s u p l aɪ
supportnya	s u p ɔ r t ɲ a
surachman	s u r a χ m a n
surahman	s u r a h m a n
suraiya	s u r aɪ j a
suraji	s u r a dʒ i
surat	s u r a t
surati	s u r a t i
surau	s u r aʊ
suri	s u r i
suripto	s u r i p t o
suroyo	s u r o j o
surti	s u r t i
suruhan	s u r u h a n
survei	s u r v ɛ i
surya	s u r j a
suryo	s u r j o
susah	s u s a h
susetyo	s u s ɛ t j o
susilo	s u s i l o
suspensi	s u s p ɛ n s i
sustainabilitas	s u s t aɪ n a b i l i t a s
susu	s u s u
susul	s u s u l
sutiyoso	s u t i j o s o
sutowo	s u t o w o
sutradara	s u t r a d a r a
sutrisno	s u t r i s n o
suwena	s u w ɛ n a
suwisma	s u w i s m a
suyitno	s u j i t n o
suyono	s u j o n o
suzetta	s u z ɛ t t a
swakarsa	s w a k a r s a
swasta	s w a s t a
swedia	s w ə d i a
swiss	s w i s
syabirin	ç a b i r i n
syachrial	ç a χ r i a l
syachrudin	ç a χ r u d i n
syaeful	ç a ɛ f u l
syafei	ç a f ɛ i
syafeii	ç a f ə i i
syafii	ç a f i i
syafiuddin	ç a f i u d d i n
syafnil	ç a f n i l
syafruddin	ç a f r u d d i n
syafrudin	ç a f r u d i n
syafwan	ç a f w a n
syahid	ç a h i d
syahputra	ç a h p u t r a
syahrial	ç a h r i a l
syahril	ç a h r i l
syahroni	ç a h r o n i
syahrul	ç a h r u l
syaifuddin	ç aɪ f u d d i n
syaiful	ç aɪ f u l
syaifullah	ç aɪ f u l a h
syair	ç aɪ r
syakhril	ç a x r i l
syakir	ç a k i r
syal	ç a l
syam	ç a m
syamsuddin	ç a m s u d d i n
syamsudin	ç a m s u d i n
syamsul	ç a m s u l
syamtalira	ç a m t a l i r a
syaraf	ç a r a f
syarat	ç a r a t
syarat-syarat	ç a r a t ç a r a t
syarat-syaratnya	ç a r a t ç a r a t ɲ a
syaratnya	ç a r a t ɲ a
syariah	ç a r i a h
syariat	ç a r i a t
syarief	ç a r i f
syarif	ç a r i f
syarwan	ç a r w a n
syaukani	ç aʊ k a n i
syed	ç ɛ d
syeis	ç ɛ i s
syekh	ç ɛ x
syiah	ç i a h
syifa	ç i f a
syihab	ç i h a b
syirik	ç i r i k
syofian	ç o f i a n
syok	ç o k
syuhada	ç u h a d a
syukri	ç u k r i
syukur	ç u k u r
syukuran	ç u k u r a n
syukurlah	ç u k u r l a h
syuriah	ç u r i a h
syuting	ç u t i ŋ
tabloid	t a b l o i d
tabu	t a b u
tadi	t a d i
tadinya	t a d i ɲ a
tahanan	t a h a n a n
tahap	t a h a p
tahapan	t a h a p a n
taher	t a h ə r
tahija	t a h i dʒ a
tahu	t a h u
tahun	t a h u n
taiwan	t aɪ w a n
taj	t a dʒ
tajam	t a dʒ a m
tak	t a k
takasihaeng	t a k a s i h a ə ŋ
takengon	t a k ə ŋ o n
takraw	t a k r a w
taksi	t a k s i
takut	t a k u t
taliban	t a l i b a n
taman	t a m a n
tambah	t a m b a h
tambahan	t a m b a h a n
tambak	t a m b a k
tambunan	t a m b u n a n
tampak	t a m p a k
tampaknya	t a m p a k ɲ a
tampil	t a m p i l
tamu	t a m u
tamunya	t a m u ɲ a
tamzil	t a m z i l
tanah	t a n a h
tanahku	t a n a h k u
tanam	t a n a m
tanda	t a n d a
tanda-tanda	t a n d a t a n d a
tangan	t a ŋ a n
tangannya	t a ŋ a n ɲ a
tangerang	t a ŋ ɛ r a ŋ
tangguh	t a ŋ ɡ u h
tanggung	t a ŋ ɡ u ŋ
tangkis	t a ŋ k i s
tanjungpriok	t a n dʒ u ŋ p r i o k
tanpa	t a n p a
tanya	t a ɲ a
tanyai	t a ɲ aɪ
tanyakan	t a ɲ a k a n
tapa	t a p a
tapanuli	t a p a n u l i
tapi	t a p i
taraf	t a r a f
tarakan	t a r a k a n
target	t a r ɡ ə t
target-target	t a r ɡ ə t t a r ɡ ə t
tari	t a r i
tarian	t a r i a n
tarif	t a r i f
tarif-kuota	t a r i f k u o t a
tarigan	t a r i ɡ a n
tarman	t a r m a n
tarmidzi	t a r m i d z i
taruh	t a r u h
tasawuf	t a s a w u f
tashkent	t a s h k ə n t
taslam	t a s l a m
tasya	t a ç a
tata	t a t a
taufan	t aʊ f a n
taufik	t aʊ f i k
taufikurrahman	t aʊ f i k u r a h m a n
taufiq	t aʊ f i k
tawarkan	t a w a r k a n
tawau	t a w aʊ
tawau-nunukan	t a w aʊ n u n u k a n
tawuran	t a w u r a n
tayub	t a j u b
tebu	t ɛ b u
tefa	t ɛ f a
tegas	t ɛ ɡ a s
teguh	t ɛ ɡ u h
tehnis	t ɛ h n i s
tejo	t ɛ dʒ o
tekad	t ɛ k a d
tekan	t ɛ k a n
teknik	t ɛ k n i k
tekstil	t ɛ k s t i l
telah	t ə l a h
telan	t ə l a n
telepon	t ə l ɛ p o n
teleskop	t ə l ɛ s k o p
televisi	t ə l ə v i s i
telkom	t ə l k o m
telpon	t ə l p o n
teman	t ɛ m a n
temannya	t ə m a n ɲ a
tembakan	t ə m b a k a n
tembok	t ɛ m b o k
temmy	t ɛ m m j
tempat	t ɛ m p a t
tempo	t ɛ m p o
temponya	t ə m p o ɲ a
tempur	t ɛ m p u r
temui	t ə m u i
temukan	t ə m u k a n
tendangan	t ə n d a ŋ a n
tender	t ɛ n d ə r
tengah	t ɛ ŋ a h
tenggelam	t ə ŋ ɡ ɛ l a m
tengku	t ɛ ŋ k u
tengoklah	t ə ŋ o k l a h
tentang	t ɛ n t a ŋ
tentu	t ɛ n t u
tentukan	t ə n t u k a n
tentunya	t ə n t u ɲ a
tepat	t ɛ p a t
tepi	t ɛ p i
terang	t ɛ r a ŋ
terasa	t ə r a s a
teratai	t ə r a t aɪ
terbaik	t ɛ r b aɪ k
terbakar	t ə r b a k a r
terbatas	t ə r b a t a s
terbengkalai	t ə r b ə ŋ k a l aɪ
terbentuk	t ə r b ə n t u k
terbuka	t ə r b u k a
terbukti	t ə r b u k t i
terburuk	t ə r b u r u k
tercantum	t ə r tʃ a n t u m
tercium	t ə r tʃ i u m
terdaftar	t ə r d a f t a r
terdapat	t ə r d a p a t
terdekat	t ə r d ɛ k a t
terdengar	t ə r d ɛ ŋ a r
terdiri	t ə r d i r i
terendam	t ə r ɛ n d a m
terganggu	t ə r ɡ a ŋ ɡ u
tergantung	t ə r ɡ a n t u ŋ
tergenang	t ə r ɡ ɛ n a ŋ
tergilas	t ə r ɡ i l a s
terguling	t ə r ɡ u l i ŋ
tergusur	t ə r ɡ u s u r
terhadap	t ə r h a d a p
terhenyak	t ə r h ɛ ɲ a k
terhukum	t ə r h u k u m
terhuyung-huyung	t ə r h u j u ŋ h u j u ŋ
teriak	t ə r i a k
teriakan-teriakan	t ə r i a k a n t ə r i a k a n
terikat	t ə r i k a t
terima	t ə r i m a
terjadi	t ə r dʒ a d i
terjadinya	t ə r dʒ a d i ɲ a
terjebak	t ə r dʒ ɛ b a k
terjun	t ɛ r dʒ u n
terkadang	t ə r k a d a ŋ
terkait	t ɛ r k aɪ t
terkandung	t ə r k a n d u ŋ
terkapar	t ə r k a p a r
terkejut	t ə r k ɛ dʒ u t
terkekeh-kekeh	t ə r k ɛ k ə h k ɛ k ə h
terkena	t ə r k ə n a
terkendali	t ə r k ə n d a l i
terkesan	t ə r k ɛ s a n
terlalu	t ə r l a l u
terlambat	t ə r l a m b a t
terlampau	t ə r l a m p aʊ
terlampaui	t ə r l a m p aʊ i
terlanjur	t ə r l a n dʒ u r
terletak	t ə r l ɛ t a k
terlibat	t ə r l i b a t
terlihat	t ə r l i h a t
terluka	t ə r l u k a
termasuk	t ə r m a s u k
ternyata	t ə r ɲ a t a
terompet	t ə r o m p ə t
teroris	t ə r ɔ r i s
terorisme	t ə r ɔ r i s m ə
terowongan	t ə r o w o ŋ a n
terpadu	t ə r p a d u
terpaksa	t ə r p a k s a
terpengaruh	t ə r p ə ŋ a r u h
terpental	t ə r p ɛ n t a l
terpenuhi	t ə r p ə n u h i
terpilih	t ə r p i l i h
terprovokasi	t ə r p r o v o k a s i
tersangka	t ə r s a ŋ k a
tersangkanya	t ə r s a ŋ k a ɲ a
tersebut	t ə r s ɛ b u t
terseok-seok	t ə r s ɛ o k s ɛ o k
tersetrum	t ə r s ɛ t r u m
tersimpan	t ə r s i m p a n
tersindir	t ə r s i n d i r
tersingkap	t ə r s i ŋ k a p
tersisa	t ə r s i s a
tertangkap	t ə r t a ŋ k a p
tertawa	t ə r t a w a
tertib	t ɛ r t i b
tertinggi	t ə r t i ŋ ɡ i
tertulis	t ə r t u l i s
tertutupnya	t ə r t u t u p ɲ a
terungkap	t ə r u ŋ k a p
terurus	t ə r u r u s
terus	t ɛ r u s
terutama	t ə r u t a m a
tetangga	t ə t a ŋ ɡ a
tetap	t ɛ t a p
tetapi	t ə t a p i
tewas	t ɛ w a s
thahir	t h a h i r
thalib	t h a l i b
theo	t h ɛ o
tiadanya	t i a d a ɲ a
tiang	t i a ŋ
tiap	t i a p
tiba	t i b a
tiba-tiba	t i b a t i b a
tidak	t i d a k
tidur	t i d u r
tiga	t i ɡ a
tiga-empat	t i ɡ a ɛ m p a t
tik	t i k
tiketnya	t i k ɛ t ɲ a
tim	t i m
timah	t i m a h
timnya	t i m ɲ a
timor	t i m ɔ r
timpal	t i m p a l
timteng	t i m t ə ŋ
timtim	t i m t i m
timur	t i m u r
tindakan	t i n d a k a n
tindakan-tindakan	t i n d a k a n t i n d a k a n
tinggal	t i ŋ ɡ a l
tinggalkan	t i ŋ ɡ a l k a n
tinggi	t i ŋ ɡ i
tingginya	t i ŋ ɡ i ɲ a
tingkat	t i ŋ k a t
tingkatkan	t i ŋ k a t k a n
tinjau	t i n dʒ aʊ
tinjauan	t i n dʒ aʊ a n
tionghoa	t i o ŋ h o a
tipe	t i p ə
tipis	t i p i s
tirai	t i r aɪ
tiram	t i r a m
titik	t i t i k
tki	t k i
tkp	t e k a p e
tkw	t e k a w e
tni	t n i
toba	t o b a
tobing	t o b i ŋ
togel	t o ɡ ə l
toh	t o h
toha	t o h a
toilet	t o i l ə t
toko	t o k o
toko-toko	t o k o t o k o
tokoh	t o k o h
tokyo	t o k j o
tol	t o l
tolak	t o l a k
tolhah	t o l h a h
tolnya	t o l ɲ a
tolong	t o l o ŋ
tolonglah	t o l o ŋ l a h
tomasoa	t o m a s o a
tombak	t o m b a k
tommy	t o m m j
tonase	t o n a s ə
tontonan	t o n t o n a n
tony	t o ɲ
top	t o p
topeng	t o p ə ŋ
topi	t o p i
topografinya	t o p o ɡ r a f i ɲ a
torpedo	t ɔ r p ɛ d o
total	t o t a l
tpa	t p a
tradisi	t r a d i s i
tragedi	t r a ɡ ɛ d i
tragis	t r a ɡ i s
transfer	t r a n s f ə r
transfusi	t r a n s f u s i
transgenik	t r a n s ɡ ɛ n i k
transit	t r a n s i t
transmigrasi	t r a n s m i ɡ r a s i
transportasi	t r a n s p ɔ r t a s i
trantib	t r a n t i b
trauma	t r aʊ m a
travo	t r a v o
tri	t r i
tripa	t r i p a
truk	t r u k
truknya	t r u k ɲ a
tsanawiyah	t s a n a w i j a h
tsauri	t s aʊ r i
tsunami	t s u n a m i
tua	t u a
tubuh	t u b u h
tudingan	t u d i ŋ a n
tuduh	t u d u h
tuduhan	t u d u h a n
tujuan	t u dʒ u a n
tujuh	t u dʒ u h
tukang	t u k a ŋ
tukar	t u k a r
tukas	t u k a s
tukasnya	t u k a s ɲ a
tumbuh	t u m b u h
tumengkol	t u m ɛ ŋ k o l
tumion	t u m i o n
tumpal	t u m p a l
tunai	t u n aɪ
tungau	t u ŋ aʊ
tunggal	t u ŋ ɡ a l
tunggu	t u ŋ ɡ u
tuntaskan	t u n t a s k a n
tupai	t u p aɪ
turun	t u r u n
turunnya	t u r u n ɲ a
tutur	t u t u r
tutut	t u t u t
tvri	t v r i
tyasno	t j a s n o
uang	u a ŋ
uangnya	u a ŋ ɲ a
ubah	u b a h
ubaya	u b a j a
ubi	u b i
ucap	u tʃ a p
ucapan	u tʃ a p a n
ucapannya	u tʃ a p a n ɲ a
ucapnya	u tʃ a p ɲ a
ucok	u tʃ o k
udah	u d a h
udara	u d a r a
udin	u d i n
ufuk	u f u k
ugd	u ɡ d
ugiek	u ɡ i k
ugm	u ɡ m
ui	u i
ujang	u dʒ a ŋ
ujar	u dʒ a r
ujarnya	u dʒ a r ɲ a
uji	u dʒ i
ujian	u dʒ i a n
ujong	u dʒ o ŋ
ujug-ujug	u dʒ u ɡ u dʒ u ɡ
ujung	u dʒ u ŋ
ujung-ujungnya	u dʒ u ŋ u dʒ u ŋ ɲ a
ujungpandang	u dʒ u ŋ p a n d a ŋ
ujungpangkah	u dʒ u ŋ p a ŋ k a h
ukhman	u x m a n
ukhrowi	u x r o w i
ukhuwah	u x u w a h
ukulele	u k u l ɛ l ə
ukuran	u k u r a n
ulah	u l a h
ulama	u l a m a
ulang	u l a ŋ
ular	u l a r
ulin	u l i n
umam	u m a m
umar	u m a r
umat	u m a t
umroh	u m r o h
umum	u m u m
umumnya	u m u m ɲ a
undang-undang	u n d a ŋ u n d a ŋ
uneg-unegnya	u n ə ɡ u n ɛ ɡ ɲ a
ungaran	u ŋ a r a n
unggul	u ŋ ɡ u l
ungkap	u ŋ k a p
ungkapan	u ŋ k a p a n
ungkapnya	u ŋ k a p ɲ a
unhcr	u n h tʃ r
unit	u n i t
universitas	u n i v ə r s i t a s
unjuk	u n dʒ u k
unsur	u n s u r
unsyiah	u n ç i a h
untaet	u n t a ə t
untuk	u n t u k
untung	u n t u ŋ
upacara	u p a tʃ a r a
upah	u p a h
upaya	u p a j a
upaya-upaya	u p a j a u p a j a
urai	u r aɪ
urainya	u r aɪ ɲ a
urung	u r u ŋ
urusan	u r u s a n
urutan	u r u t a n
usah	u s a h
usaha	u s a h a
usahanya	u s a h a ɲ a
usai	u s aɪ
usainya	u s aɪ ɲ a
usamah	u s a m a h
usia	u s i a
usianya	u s i a ɲ a
usman	u s m a n
ustad	u s t a d
usulan	u s u l a n
usut	u s u t
utama	u t a m a
utami	u t a m i
utang	u t a ŋ
utang-utang	u t a ŋ u t a ŋ
utara	u t a r a
utomo	u t o m o
uud	u u d
uzbekistan	u z b ə k i s t a n
uzur	u z u r
vaksin	v a k s i n
variabel-variabel	v a r i a b ə l v a r i a b ə l
vegetasi	v ɛ ɡ ə t a s i
venezuela	v ɛ n ə z u ɛ l a
verbal	v ɛ r b a l
verbalisme	v ɛ r b a l i s m ə
veron	v ɛ r o n
versi	v ɛ r s i
verzola	v ə r z o l a
vespa	v ɛ s p a
veteran	v ə t ɛ r a n
via	v i a
victor	v i tʃ t ɔ r
vidjongtius	v i dʒ o ŋ t i u s
viegas	v i ɡ a s
vieira	v i i r a
vietnam	v i t n a m
virtuositas	v i r t u o s i t a s
visi	v i s i
vital	v i t a l
vodka	v o d k a
vokal	v o k a l
voli	v o l i
volume	v o l u m ə
volvo	v o l v o
vonis	v o n i s
voting	v o t i ŋ
vulkanologi	v u l k a n o l o ɡ i
wacana	w a tʃ a n a
wachid	w a χ i d
wagub	w a ɡ u b
wah	w a h
wahab	w a h a b
wahai	w a h aɪ
wahid	w a h i d
wahyudi	w a h j u d i
waihaong	w aɪ h a o ŋ
waimuri	w aɪ m u r i
wajah	w a dʒ a h
wajar	w a dʒ a r
wajib	w a dʒ i b
wakapolres	w a k a p o l r ə s
wakapolri	w a k a p o l r i
wakasatgasres	w a k a s a t ɡ a s r ə s
wakil	w a k i l
waktu	w a k t u
waktunya	w a k t u ɲ a
walau	w a l aʊ
walaupun	w a l aʊ p u n
walhi	w a l h i
wali	w a l i
walikota	w a l i k o t a
waluyo	w a l u j o
wamena	w a m ɛ n a
wanandi	w a n a n d i
wanita	w a n i t a
wapres	w a p r ə s
wapresnya	w a p r ɛ s ɲ a
warga	w a r ɡ a
warganya	w a r ɡ a ɲ a
waris	w a r i s
warna	w a r n a
wartawan	w a r t a w a n
warteg	w a r t ə ɡ
warung	w a r u ŋ
warungnya	w a r u ŋ ɲ a
wasit	w a s i t
waspadai	w a s p a d aɪ
waspadalah	w a s p a d a l a h
wates	w a t ə s
wawancara	w a w a n tʃ a r a
wayang	w a j a ŋ
wayn	w a j n
wbc	w e b e tʃ e
wejangan	w ə dʒ a ŋ a n
weker	w ɛ k ə r
weleri	w ə l ɛ r i
wenas	w ɛ n a s
wenda	w ɛ n d a
werdy	w ɛ r d j
wesel	w ɛ s ə l
wetan	w ɛ t a n
weton	w ɛ t o n
wewangian	w ɛ w a ŋ i a n
wewenang	w ə w ɛ n a ŋ
wewenangnya	w ɛ w ə n a ŋ ɲ a
who	w h o
wianta	w i a n t a
wibowo	w i b o w o
wicaksono	w i tʃ a k s o n o
widhiyanto	w i d h i j a n t o
widi	w i d i
widigdo	w i d i ɡ d o
widjanarko	w i dʒ a n a r k o
widodo	w i d o d o
wig	w i ɡ
wiharto	w i h a r t o
wilayah	w i l a j a h
wildan	w i l d a n
wilfred	w i l f r ə d
wilis	w i l i s
wimar	w i m a r
winarno	w i n a r n o
wira	w i r a
wirabhakti	w i r a b h a k t i
wirahadikusuma	w i r a h a d i k u s u m a
wiranu	w i r a n u
wiraswasta	w i r a s w a s t a
wisata	w i s a t a
wismoyo	w i s m o j o
wisnu	w i s n u
witono	w i t o n o
wiwoho	w i w o h o
wni	w n i
wolfensohn	w o l f ɛ n s o h n
wolter	w o l t ə r
wonogiri	w o n o ɡ i r i
wonokromo	w o n o k r o m o
wonorejo	w o n ɔ r ɛ dʒ o
wonosari	w o n o s a r i
wonosobo	w o n o s o b o
wortel	w ɔ r t ə l
wowor	w o w ɔ r
wtc	w e t e tʃ e
wto	w t o
wudu	w u d u
wujud	w u dʒ u d
wujudkan	w u dʒ u d k a n
wukuf	w u k u f
wulan	w u l a n
wuryanto	w u r j a n t o
ya	j a
yacob	j a tʃ o b
yafie	j a f i
yahya	j a h j a
yaitu	j aɪ t u
yakin	j a k i n
yakni	j a k n i
yakob	j a k o b
yakub	j a k u b
yanatera	j a n a t ɛ r a
yang	j a ŋ
yanusa	j a n u s a
yaohan	j a o h a n
yasin	j a s i n
yassin	j a s i n
yayasan	j a j a s a n
yayuk	j a j u k
yel-yel	j ɛ l j ɛ l
yenny	j ɛ n ɲ
yerussalem	j ɛ r u s a l ə m
yesus	j ɛ s u s
ylbhi	j l b h i
ylki	j l k i
yogya	j o ɡ j a
yogyakarta	j o ɡ j a k a r t a
yohanes	j o h a n ə s
yoichi	j o i χ i
yopi	j o p i
yoris	j ɔ r i s
yos	j o s
yosfiah	j o s f i a h
yoshiro	j o s h i r o
yoyo	j o j o
yozi	j o z i
yubert	j u b ə r t
yudho	j u d h o
yudhoyono	j u d h o j o n o
yudikatif	j u d i k a t i f
yuen	j u ə n
yugoslavia	j u ɡ o s l a v i a
yulia	j u l i a
yunani	j u n a n i
yunior	j u n i ɔ r
yunus	j u n u s
yuridis	j u r i d i s
yus	j u s
yusril	j u s r i l
yusuf	j u s u f
yuwono	j u w o n o
yuyun	j u j u n
yuzril	j u z r i l
zaenal	z a ɛ n a l
zage	z a ɡ ə
zainal	z aɪ n a l
zaini	z aɪ n i
zainudin	z aɪ n u d i n
zainul	z aɪ n u l
zakaria	z a k a r i a
zakat	z a k a t
zakiah	z a k i a h
zakir	z a k i r
zaldy	z a l d j
zaman	z a m a n
zamannya	z a m a n ɲ a
zarkasih	z a r k a s i h
zarnubi	z a r n u b i
zat	z a t
zebra	z ɛ b r a
zein	z ɛ i n
zeldy	z ɛ l d j
zemin	z ɛ m i n
zen	z ɛ n
zendrato	z ə n d r a t o
zeni	z ɛ n i
zia	z i a
ziarah	z i a r a h
zimbabwe	z i m b a b w ə
zionis	z i o n i s
zipur	z i p u r
zohra	z o h r a
zona	z o n a
zona-zona	z o n a z o n a
zonasi	z o n a s i
zone	z o n ə
zubaidi	z u b aɪ d i
zubair	z u b aɪ r
zuheir	z u h ɛ i r
zuiyen	z u i j ə n
zukri	z u k r i
zulfadli	z u l f a d l i
zulfan	z u l f a n
zulfikar	z u l f i k a r
zulkarnaen	z u l k a r n a ə n
zulkifli	z u l k i f l i
zulvan	z u l v a n
zumrotin	z u m r o t i n
